----o----o------B-----Eo----------------B----o---------------o-------o---------o-----oX------X--------o---------o?----------------------------o---M------------E---B------------------------------o--?--
---------------o--o-----oX--B------------------------------E---X--------------------o---o-----X---o-------------o-------o------------------------------B-----X----------o----X---B---------o--------?---
----------X------E---------------o----------------------------B--------------------------------------o---------------------Bo---------B-----------------------------------------------------------------
---------------------------o---------B-------------o-------EM----E-------------------------------------------------------------o------------o----------------------o-------B--o-----------B----?--------
-----B-------M--B-----B---o----------oB------------------B---------------------B------------------o-------o--o-----------------------o-----------o----E-o--o----------o--------------o-----?--M-------?-
------B?------o-?--B----------------E-------XBX----o-----------------------------------E-B---o------E--o-X----E-----------------------------------B---X----------X--------------------X--------------o--
--------------------------------------o-----o----o---X--------------------------------------B--E------------B--M-o--------------o--X-X------------------B-----------o---------------o-------------------
--B------------B-------------------------o-------------B-----M?-o-B--B---B------X-B---------------Eo----------E-------------MB------B--------B----B--E--------------------------o----------B--------B--v
---o-o----E-----oB--XBB--------------o-----------------o---?----E--X-----X-------------o-B---------o----o-------o----o-----B-----------B------------X--B--------------o-----o--?--------E------o-o------
---------------M----B--------------------------o-M-----------------------------X-E------------------------------B----B---------------o------?---o------o-o---o-----------B----------o----o----E-------o-
-------------B-------------o-E-------------------X---B--BB--------------XoB---------------B----------------------------------------------------------o-------o---------T----------B----------B--------E-
------------o--oo--o------------XEM-------------E----?------------------------------------------o----o---------------?---?------------?----------B------Eo--B---------o|---B-------------o-X-------X----
------------------o?-----------o-----------o---------B---?---ooT----T-?-----?---------X---------------------B----o---o------X-------o---------o---------T----ooo-------|-o-----------------------------E
-------E----M--o------------M-------------o--X-------o----?----|---B|---o------o-------o----------B-------X------------o------------o---------B------o--|------------?-|----------------------------o---
mo------------o------o---------------------?--o--------------BE|?-M-|-------o-o----M-----------------------B---------EX----------------X--------------E-|B-------------|-E---T-o------?-----------------
XXXXXXX--XXXXXXXXXXXXXXXXXXXXXXXXXXXXXXXXXXXXXXXXXXXXXXXX-XXXXX|XXXX|XXXXXX-XXXXXXX-XXXXXXXXXXXXXXXXXXXXXXXXXXXXXX-X-XX-XXXXXXXXXXXXXXXXXXXXXXXXXXXXX-XX|XXXXXXXXXXXXXX|-XXXX|XX-XXXXXXXXXXXXXXXXXXXXXXX
