--------------------o-----------M--o---------o--------B------------------B-----B---E?o-----o---------------------M------------Bo-------o--B-------------------------?-----------E---------------oB------
-oo---B----o--B--------o-------B--B-------------------Xo-X-------o----------------------------------------------------o-----------------------------------o----B-------E-?----------------X--------?----
------?---X-----------------B--B---------o-------------------B----B------------o---------------B-------o-----------------------B--------------------------?---------------------------------------------
-B-o-------------o-M---M--------o---o-B----o--XX----M--o-----------------------------------B-------B---E-----Mo-B--B-----o----?----------------------------------------------B----------------o----o----
------X---oo-----o-------------?-------------------------------------B----------o------------------o---o--------?--o-------o-----X-----B----B-o----------o------------M---?----------B------------M-----
------------------B-----M-------o-----------o-----B---o-----oo-----------------?E----o-------Bo----------------o--------E----M------XEBo----------B---o-o--o---B--E-----?------------o------------B-----
--------------------B-----------------o---------------B-------o-------------------------------X-----B---------------o-----------------------------------------B-------oo-----B-----------o--------------
---------E--B---E----B-----------------o-----------------------------B----o---------B--------------------------------?------M---------------------------o?----oo---------------?-B-----o--o-----oo-----v
-----------------E--M-------o---?------o------?---------------------?-----oM-----B------?--o--------X-------B-------------------------------o--o---B------------------------o---------B---------------o-
----------------------------------------------B-----------B---------------o------------------B-------------B-------M------------o----?-------------B-------o----------B----------o-------------?--------
--o-------------X--------------------------------o----M-----------------------------E------------------B---o-------o----o--o-------E---E----o-M-T-------------------E----E-----------------B----B-----o-
-------o-----o---B--------------------------------B---------o--------M-E-------------------E|----------------M--------?--------E-----o----o---?---------------------Bo---------o---?--------------B-B---
------B-?------------o------------o---------------------------M-----------------------------|-?-------------o------------------------B----o----M-------M-------------------------o------M--oo-----------
--B--------B-E--------------------o---o-------o-------------------o------B--------o----------|o--|---M------------------------------------E--B--------M----o----------------------B---------------------
m-X-----------------------------------?----B-?--------o-------oo----------------o-o---------?|---|--X----o---------E-------ME----B---------------------------M---------------o---B----------------o-o---
XXXXXXXXXXXXXXXXXXXXXXXXXXXB?--XXXXXXXXXXXXXXXXXXXXXXXXXXXXXXXXXXXXXXXXXXXXXXXXXXXXXXXXXXXXXB|XXX|XXXXXXXXXXXXX-XXXXXXXXXXXXXXXXXXXXX-XXXXXXXXXX|XXX-XXXXX-XXXXXXXX|XXXXXXX-|XXX|XXXXXXXXXXXXXXXXXXXXXXX
