----------------B----------------------------------------------o----?-----o------------------------X-------E-o---------------B------------------o--o----------------------?--------------------------o--
---------------------------------------------------------------o-o-----------B----o---------Bo---o------B-------------------------------o-----o--------------------------------M--oB--------------------
----------------B---------E-B--------------B------------------------M---------o-X--------B--o---X-o-------------B-----------------B----------------------------------------M-------o-------oE------?--o-
-------------------------B-----B-----------E-B?-----------XE--E------------B-----o-----------------o----?o-------------------B-o--------------------B-----o---------------BBM-------oM-------------B-oo-
--------------o----o-------M--o-o-----------------------------------------oo-----B--------o-----oo----------X------------E--------------------------------M------------------o--------------------------
B-E----o?-----E--o----------E--------------------oX----------BB------oX--------o------oo--o-----------o---E-o----------o-?----o-o---------B--o------o-B-----------------------------?-----------o-------
-----?--BB-----------o---------------Bo----------------------o---------B-o--o-------------------------E--------B-------------o----------------?--------B-E----------------------------------------o-----
o----------B--------B-----?-E-o---------M-----------------------------------------------B----X--------------------------------------------o---------o---o-------oo-o-B---------------------------------v
-----------B---o-----E----------------------oMB-o-o-------?----------------------------------------B----------------B------o----B-------------------o---------B----o-------------?-o--------------------
------------o--B-----B----------------------o-B-----------o-o-------------o----B-----------------o----------E-----------M--------M--o-------B--o---X-------------E----B--------oB---------------B-------
o----X-------o-------o---------------o-----------X--o-X---------oBo-o----B----X--E-----------B--------------o----------o---B-------------??----B-----o-M------------X----E----B-----------------o----M--
-----o-X------o--oo---------------o--------------o----------------------------------o-M---------o---------M---o---?--o-E---------o-------------Eo-o-T--?---------------oB---------------------o-------X-
--------------o------------------------X--------------?------B----oE----------------?---E--M---------B-----o--?----o---o-----------------------o----|-------------------o--B--o-----o----T--------------
------B---------------o-------o-----o-o------BB------BBX----M---------------------------------------------------------------o-o-----------------T---|---------------o--------------E--o--|-----------T--
m------------------E----------------?--E-----B----o-------------T---o---B--o-----oXo----------o-o--------------X-o-o---X---------o-----B--------|o--|o-------------B---?----------T------|---o---B---|--
XXXXXXXXXXXXXXXXXXXXXX-XXXXXXXXXXXXXXXXXXXXXXXXXXXXXXXX-XXXXXXXX|XXXXXXXXXXX-XX-XXXXXXXXXXXXXXXXXXXXXXX-XXXXXXXX-XX-XXXXXXXXXXXXXXXX-XXXXXX-XXXX|XXX|XXXX-XXXXXXXXX-XXXXX-X-XXXXXX|XXXXXX|XXXXXX-XXXX|XX
