---------M--------M---T-----X--o-X---B-----------------------------B?---E------B--------------------E--X--------------?--------------B-----M--X----B-E-------B-------B-----------BX--------B-------E----
-B---B--?--------------------?T-----o-XX---B------------------------B-E--B----M-X-----------------B-------------E---B----------X-----X----------X----------------------o---------------o--B------o-----E
---o-------o-------?--|----|-B-----M----------|--M----X---X-------M-------------------------------o---?-------o-------------?-?-----------B---o?----B--------o---------------BB-------------E-----------
----------------?---X-|o---|------B----B------|---M----------------------M---X------------B------------B------EX-------X---X--B---X---------XEo---E-------------X------------------?--?-----------?-B---
----------E-----------|----|oE-B----M---------|----BX--B---E---B--------M-------T-----BB-----B-X---B--------?-------B------------o--E---E--B-?-?-------|---B--E------?------X---Bo--B---X-X-----------o-
-------X--Bo----------|M---|---------BB-----B-|--------------X-B--B-------------|T--------X---B------M------------X-----------T--X--T--------B---------|------------E-----------------B-X----|----B--B--
--E---------------Bo-E|-T--|--|B-----------|---------|-------B----T------o--------?-----------------X---|---M----M--------------X--------------------------E?-------------B----------------MX----X------
X-----------------o-----------|---T----XB--|---------|----E--o----|---BE-----E---------o--?E-??---------|--M-----------------TE-----------------------------?--X--T--o-------------------------?---B-o-v
---------X?-----Bo-E--|-|--|--X---E--------X--|-E-----------E--o--------------T-||---------T----B-----B--M----B--M----------B-|-----|---|E----M-----M-T|B----BBB----B----?--B---|-----B------|----------
T--X------T-B---------|-|--|B-----------------|------------------B|--M--o-B--------------B--------B---o-|B---------------E---|------o---------------------o-------|--T----B-BB---------B-B----B--o--|---
----------|-----------|o|-B--------?----------|o-E-------T----------M---------|-||--------o|---?---------E-----?----o---XB----|-----|X--|--?----------||-------M-----B----------|---------------E---|---
----X-T---|XB---------|-|--|--o-----X---------|B--o------|-------X------------|-||-----?---|--T--------------o------oE------M-|-?---|--M|-------B-----||---------?--------------|-B----------o----E-|---
-B--B-|---|--------B--|-|--|--T---E----------E|----------|-----------------?--|-||B--------|-B|-M-----B-----------X---T-------|-----|-------------X------E----E---|-X|---M----E--o-E?o--------------|---
--oB--|---------B|---E----o---|---|--T-----|---M-----|---M-----B|-|B--|-------------?------B------------|------?-----T------M|--------B--------------------------X|--|-EE--------B------------------|---
m-----|---|------------B------|-E-|--|-----|X--------|-M--------|-|---|----------------B-----E-----T---o|-B----------|-------X------BEo------XE---o---M--?-E------|--|---------E--EE---------BX-----|---
XXXXXX|XXX|XXXXXXXXXXX|X|XX|XX|XXXXXXXXXXXXXXX|XXXXXXXX|X|XXXXXXXXXXXXXXXXXXXXXXXXXXXXXXXXXXXXXXXXX|XXXX|XXXXXXXXXXXX|XXXXXXX|XXXXXXXXXXXXXXXX-XXXXXXXXXXXXXXXXXXX|XX|XXXXXXXXXXXXXXXXXXXXXXXXXXXXXX-XXX
