--------o------------------------------o---o---------------------o---------------------E-----E-----?----------------------------X?----------o------------------------B-E--------------------------------
----B--------------------------------------------------B---B-----------------o-----------------------------E?--B--------o------??-o------------B---oo-B---------B----oB-----------------------B---------
--------------o----------E---------------B-----------------o------------o-------E-----------o-----------------------------oX-----------oB----B--------------------------------------------?----------B--
--------------------------o---------------------?------------------XE----o-----------------B------E------B----------------------------------o---o-----o-------o-----------------M-o----BM---------------
-----X-----B---------B----B-------------------o--?-------------------B-----------o-------------------------------B--------o---------------o------------------------o-------------------------------o-?--
--M---------EB--o-------o-----E----------------------?-----X---------o-----o---------------------B----------------------------B-----?------o-------------------------E-B-----------------------o--------
--B-----B---------B---------------------B--o--o----?-------??--B-o------------o-------------M-----o---------B----o--------------X---oTMM----o-------X---------------?---------o----------o----------o---
------------?---B-------------------------o------B-----BoB--------------------------o-------------------B-------------o-----------B--------------o---o---------B-----B-------------o---o---------------v
---------o-----o-o------?----------o-------------------------X-----o---o----------B--------------E------------o---o----------o------------------------X----------o-------------X----------o---X-----B---
----------------o-----------------------------B-------------X--------------------------B----?------------o---o--o--X---o------------o--?---------------------o--B-X---------BB-------------------B----o-
----o---o------------------------------o------o--B-------o---X----------------X--------------B--?-----------------------E----------------------------B--T-X--------------B------------------o-----------
-------------?----o------------------------?---------------------------B------E-------------o------------------Xo-----------------------------X------o------MB-----M----------B-B------------oo---------
---------o--------B-------o-T--o----o-------------------------o---B---------------o------------------------------o-----------o---o|---------------------|-------M---M-B---o-----------------XB--------B-
------------------o--------o--------------------------------------o------------------T-------------T-----------o-------o----------|E-------------o------|-------------o---------------------oB----------
m----o---B-------Mo------E--|--o-E-----E---------------?B-o---B---------B----o-------------B-------|----?-----?o-?-------------B-------o----------o--------------o------B--------E-------o--------------
XXXXX-XXXXXXXXXXXXXXXXXXXXXX|XXXXXXXXXXXXXXXXX-XXX-XXXXXXXXXXXXXXXX-XXXXXXXX-XXXX-XXX-XXXXXXXXXXX-XXXXXX-XXXXXXXXXXXXXXXXXXXXXXX-XXXXX-XXX-XXXXXXXXXXXXXXXXXXXX-XXXXXXXXXX|XXXX--XXXXXXXXXX-XXXXXX|XXXXX
