--o----------B-----EB-o-----------BM----------X-----o---------------------?-o---------------------------------------------E------o-----------------X-M----?----M--------B-------?oX--X------o-----------
o----------------------B---E-?-o---oB---------------------?---------B---B-------------?---B-o------------B---Xo-------------------------o-----------------------o--B-----o-------------------B-----o---X
------------------------Boo----------------o-----------------------------B------------o---oB------------------------o-------o---o----------------X--------------------?----o----------------------------
--B-----------B-o--o----B-B-o-----------------B----o-----?---EB----X-----o----B-BX-----------o-o-o-------------M-----------o------MB--------------B----------------o--?-----------?------------BB--o----
---BB-E--X--o--------X------------------------E--oo-------------B--------------------------o-----o-------o--o--------Xo---------------B-------E---------------Bo--o---------------------------------X---
--------o---------------------------------o-B--X------------------------------------------o------------------------------------o-----oX----------------------------o---------B----o----------o-o--------
---------B-------B--XB-----------------------------------------o----------X-------------o-BE--------------o--oM-------o--------M----------------------------?-------------------E------------Bo--?--?---
?-------B--------------------o---B---------------------------------------o-----------o---------------------------------------?-----B--------?-------B-----------B--------------X----?o-o---?o------B---v
--------EoX-X----------B---?---------------------E--------o-------X--Bo-----X-o-----------------------------------------o---B------------------------------------E--o---o----o---------B--?-------------
---o---o-X---o-----oB------E-------------------M--------------o--------------------E--X----o----MB----o--------E-----------------------------------------B-----o-----E-----E--------o---X--o-?M---------
------o-o--o-------T-o--o-?--B-X--?-----------------------------------o--------------------oB-o--o-------------o-------------B------------?--o-B--B-----E---oo------X--------------B---B--------------B-
----o--B-B--o--XX--|----------o-o------M-o--o---------------------------------oB-B-------o---------------------------------------------------------oo--------BM---------o---X------E-B----------o-------
-------o-----------|----------------o-------------------------M---T---------B--------o-X--E--E---o---------------------------o--------------oX------o-----------------o-------------------o----oo-------
------------------o|---------------------------------------o------|-------B---Xo--o-------------------?--o--oo-----B----B-----------oE-----B------------?------------o----------------o--B-----M--------
m---B-------E------|--------B-------------------o---|----------------------o--|---------E----o-----------o-------------o-?---------T-----o-T-----o----------------?-o---o--EBo?----o-o--------X---------
XXX-XXXXXX-XXXXXXXX|XXXXXXXXX-XXXXXXXXXXXXXX-XXXXX-XX-XXXXXXXXXX-X|XX-X-XXXX-XXXXX-XXXXXXXXXXX-XXXXXX-XXXXXX-XXXXXXXXXXXXXXXXXXXXXXXXXXXXXXXXXXXXXXXXXXX-XXXXXXXXXXXX-|XXXXXXXXX-XXXXXX-XXXX-TXXXXX--X-X
