-------------------------------------------------------------------------------------------------------------------------------------------------------------------XXXXXX-------------------------------
------------------------------------------------------------------------------------------------------o-------------------------------------------------------------------------------------------------
----------------------------------------------------------------BBBBBBBB--------------------------------------------------------------------------------------------------------------------------------
--------------------------------????????------------------------------------------------------------------------------------o---------------------------------------------------------------------------
-----o------------------------o-------------------------??????------------------------------------------------------------------------------------------X-------------------XX--------------------------
---------------?----------------------------------------------------------------------------M-----------------------------------------------------------------------------------------------------------
---------------------------------------------------------------------------o-----------------------------------------------------------------------------------------------------X---?------------------
----------------------------------------------------------------------------------------------------------------------------------X--------------------------B------------------XX------o--------------v
---------------------------------------------------------------------------------------------------------------------------------XX--------------------------------------------TXX---------------------f
-------------------------------------------X------------------------------------------------------------------o-----------------XXX-------------?-----------------------------X|XX---------------------f
-------------------------------------------XX----------------------------------------------------------------------------------XXXX------------------------------------------XX|XX---------------------f
-----------------------------T-------------XXX---------------------------T----------------------------------------------------XXXXX-----------------------------??----------XXX|XX---------------------f
-----------------------------|-------------XXXX--------------------------|---------------------------------------------------XXXXXX----------T-X-----------o-----------o---XXXX|XX---------------------f
-----------------------------|---------T---XXXXX-------------------------|--------------------------------------------------XXXXXXX----------|----------------------------XXXXX|XXT--------------------f
m----------------------------|---------|---XXXXXX--X---------------------|--------------E--------------------------E-------XXXXXXXX---------M|----------------------M---EXXXXXX|XX|--------E-----------X
XXXXXXXX--XXXXXXXXXXXXXXXXXXX|XXXXXXXXX|XXXXXXXXXXXXXXXXXXXXXXXXXXXXXXXXX|XXXXXXXX--XXXXXXXXXX-----XXXXXXXXXXXXXXXXXXXXXXXXXXXXXXXXXXXXX-XX--|----XXXXXXXXXXXXXXXXXXXXXXXXXXXXX|XX|-----XXXX-XXXXXXXXXXX
