--------------------------------------------------------------------------------------------------------------------------------------------------------------------------------------------------------
---------------------------------------------------------------o---------------------------------------------------------M------------------------------------------------------------------------------
------------------------------------------------BBBBBBBB------------------------------------------------------------------------------------------------------------------------------------------------
----------------------------------------X---------------------------------------------------------------------------------------------?????-------------------------------------------------------------
-------------------------------------------------------------------------------------------------------------------------------------------------------------------------X------------------------------
---------------------------------------------------------------------------------------------------------------------------------------------------------------BBBBB----XX-------------------T----------
--------------------X---------------------------------------------------------------------------------------------------------B----------------------------------------XXX-------------------|----------
---------o---------XX-----BBBBBBB-------------------------------------------------------------------------------------------------------------------------------------XXXX-------------------|---------v
------------------XXX---T---------------------------------------------------????-------------------------------------------------------------------------------------XXXXX-------------------|---------f
-----------------XXXX---|-------------------------------------------------------------------------------------------------------------------------------------------XXXXXX--------???o????---|---------f
----XX------o---XXXXX---|----------------------------------------------------------------------------X--------X----------------------------------------------?-----XXXXXXX-------------------|---------f
---------------XXXXXX---|------------------M---------------o-------------------------------------------------XX---------------------------------------------------XXXXXXXX-------------------|---------f
--------------XXXXXXX---|-----------------------------------------------------------------------------------XXX--------------------------------------------------XXXXXXXXX-------------------|---------f
-------------XXXXXXXX---|XXXXXXX-------------------------------T------------------------------------------XXXXX-BBBB---------------------BBBBBBBB---------------XXXXXXXXXX--????-------------|---------f
m-----------XXXXXXXXX---|------------------------------------E-|------------------------------------------XXXXX-----------------------------------------X------XXXXXXXXXXX------------???----|---------X
XXXXXX--XXXXXXXXXXXXXXXX|XXXXXXXXXXXXXXXXXXXXXXXXXXXXXXXXXXXXXX|XXXXXXXXXXXXXXXXXXXXXXXXXXXXXXXX--------XXXXXXXXXXXXXXXXXXXXXXXXXXXXXXXXXXXXXXXXXXXXXXXXXX-XXXXXXXXXXXXXXXXXXXXXXXXXXXXXXXXXX|XXXXXXXXXX
