--------oM------BT------------B----?--------?-------------?------------M------oB--------------------E--X--------------?--------------B-----M--X----B-E-------B-------B-----------B---------B-------E----
-B---B--?-------------|----T---------------X--TBX------------B-------------B?-M-X-----------------B-------------E---B----------X-----X----------X----------------------o---------------o--B------o-----E
---o-------o-------?--|----|-B-----M----------|--M----X---X-------M------------------------------------------Xo----B-----?--?-?-----------B---o?----B--------o---------------BB-------------E-----------
----------------?---X-|o---|------B----B------|---M----------------------M---X------------B------------B------EX-------X---B-------B----------------?--|--------X------------------?--?-----------?-B---
----------E-----------|----|oE-B----M---------|----BX--B---E---B--------M-------T-----BB-----B-X---B--------?-------B------------o--E---E--B-?-?-------|---B--E------?------X---Bo--B---X-X-----------o-
-------X--Bo----------|M---|---------BB-----B-|--------------X-B--B-------------|T--------X---B------M------------X-----------T--X--T--------B---------|------------E-----------------------------X-----
--E---------------Bo-E|-T--|--B---------------|---X-----o-----M--?T------o--------?-----------------X---|---M----M--------------X--------------------------E?-------------B----------------MX----X------
X-----------------o---|B|--|------------------|--------------------o?-------?--E||---------M--M-?---------------------o---M---|B----|--B|-----E-------------?--X--T--o-------------------------?---B-o-v
---------X?-----Bo-E--|-|--|--X---E--------X--|-E-----------E--o--------------T-||---------T------------|X--?-B--------------|-----B-----------E--------------X-?-|-----B-BB-------?----------------T---
T--X------T-----B|------------|---|--------|------o--|-----------B|--M--o-B--------------B--------B---o-|B---------------E---|------o---------------------o-------|--T----B-BB---------B-B-------o--|---
----------|-----------|o|-B|-------?----------|o-E-------T----------M---------|-||--------o|-------------E-----?----o---XB----|-----|X--|--?----------||-------M-----B----------|---------------E---|---
----X-T----XB---------|-|--|--o-----X---------|B--o------|-------X------------|-||-----?---|--T--------------o------oE------M-|-?---|--M|-------------||---------?--------------|-B---?-T----o----E-|---
-B--B-|---|--------B--|-|--|--T---E----------E|----------|-----------------?--|-||B---------M---BXE-----|--oo----------------|--------------------X------E----E---|-X|---M----E--o-E?o--------------|---
--oB--|---|-----X-----|-|-o---|---|--T-----|---M-----|---M-----B|-|B--|-------------?------B------------|------?-----T------M|--------B--------------------------X|--|-EE--------B------------------|---
m-----|---|----------X|-|--|--|B--X--B--E-----|------?-|-|--------------?-----|-||-----B-----E-----T---o|-B----------|-------|----?-BEo------XE---o---M--?-E------|--|---------E--EE---------BX-----|---
XXXXXX|XXX|XXXXXXXXXXXXXXXXXXX|XXX|XX|XXXXX|XXXXXXXXX|XXXXXXXXXX|X|XXX|XXXXXXXXXXXXXXXXXXXXXXXXXXXX|XXXX|XXXXXXXXXXXX|XXXXXXX|XXXXXXXBXXXXXXXXXXXXXXXXXXXXXXXXXXXX|XX|XXXXXXXXXXXXXXXXXXXXXXXXXXXXXX|XXX
