X------B-----------------------E--------------o----o-----o-----------------------------------------------B---------------------?-Bo--------?-------B------------o-o------M--E--------o---B--------------
-------------------o--------------------------------M------M---------------------------------------?--o------X-------------------------B-----------------------------------------------------------M----
?---------B----B-o----------------------------------M-----------M---------------o---------------------?--------------?-----------------------------------B-------o-----------E--o---X------------B------
--------------o------B-------------------------o---o-----------------------------B--o---o--------------------o----------------------------------------o--M--------?-?----oX-------------B---------------
o--o-B----------B-------B-------B-------------B-----------------B?-M--?---------M--------B----B----------o--o---------------------X---------M-------B-------------------------------o-------------------
--------------o--------------------o----------E--------?---------------B---------B-----------------------o------?----B-------XX--------------oB------X--B-B--?------------B-------------BM--------------
--o-?----E-------------------o-B-X---------------------E-o-o-------------------B-------------------------o--B-o--o----------------o------------------o--X---------------------B--------------o------X---
--?-----B-------------------------------B-----------B-------?------B----B------------?----------------------X--X--------B-----------------------?-o---o---------------o---B--------BX----------------M-v
---?--------M--------------------o-----------------------------------------?---------o-------------------------------------o--------o-----B----------------B---------------X----M-B?--------BM-?--------
T-M-------------------?B------------------o---------------------------o----o--o-B-------B-----------?-------------o-------E---X-?---------------o--------------o-o--B--X--------X--B--o---------------o-
--o-E------B----------B-----o------------o--------------E------------------E--------------------?---B?---------------o----------------o-BX--------------------------------B--o--------E---X-------------
----o--------------B---------o-o-----?-------M----X-M------------------B--E--M-M-E--------------------------------------------B-------------?-----E--------T--------o---------------M---B----?----------
--------B----?--o---T--o---------X-----------?-----------X----------X-B-------------o---B----o-o-------------E------o------?---------------------B-------?-----------------M------M---X-------T----M---o
---------------T----|-T-------------B--------------------------------------------o--------o---B--------------o--------------------------------o----------X-|o|--------------------B-----------|-o-------
m----oB----------o--o----E----------------E---------B---------B------------o----------------B------B------------T---------B---E----o--------?---B--o----o--|-|-o---------------M------------E-|B---X----
XXXXXXXXXXXXX-X|XXXX|X|XXXXXXXXXXXXXXXXXXXXXXX-BXXXXXXXXXXXXXXXXXXXXXXXXXXXXXXXXXXXXXXXXXXXXXXXX-XXXXX-XXXXXXXXXXX-XMXXXXXXXXXXX-XXXXXXXXXXXXXXXX-XXXXXXXXXXXXXXXXX-XXXXXBXXXXXXX-XXXXXMX-XXXXXXXXXXXXXX
