-------------------------------------------------------------------------------------------------------------------------------------------o------------------------------------------------------------
---------------------------------------------------------------------------------------------o-------------------------------------------------------------------------------------------------o--------
--------------------------------------------------------------------------------------------------------------------------------------------------------------------------------------------------------
-------------------------------------------------------------------------------------------------------------------------------------------------------------o------------------------------------------
--------------------------------------------------------------------------???-------------------XXXXX---------------------------------------------------------------------------------------------------
---------------------M------------------------o---------------------------------------------------------------------------------------------------------------------------------------------------------
-----------------------------------------------------------------------------------X--------------------------------------------------------------------------------------------------------------------
---------------------------------------------X------------------BBBBBBBB------X---XX-----------------------------M-------------------------------------------------------------------------------------v
-??--------------------------------------------------------------------------XX--XXX-----------------------------------------------------------------------??????----------------------------------XXXXf
----------------------------------------------------------------------------XXX-XXXX-------------------------------------------------------------------------------------------------------------------f
----------------o----------------------------------------------------------XXXXXXXXX-------------------------------------------------------------------------------------------------------------------f
--------------------------------------------------------------------------XXXXXXXXXX-------------------------------------------------------------------------------------------------------------------f
-------------------------------------------------------------------------XXXXXXXXXXX-------------------------------------------------------------------------------------T-----------------------------f
------------------------------------------------------------------------XXXXXXXXXXXX-------------M-----------------------------------------------------------------------|-----------------------------f
m------------E------E-------E--------------------------E-E-------------XXXXXXXXXXXXX--------------------------------E--------E-----------------------------E-----------E-|-----------M-----------E-----X
XXXXX-----XXXXXXXXXXXXXXXXXXXXXXXXXX--XXXXXXXXXXXXXXXXXXXXXXXXXXXXXXXXXXXXXXXXXXXXXXXXXXXXXXX---------XXXXXXXXXXXXXXoXXXXXXXXXoXXXXXXXXXXXXXXXXXXXXXXXXXXXXXXXXXXXXXXXXXX|XXXXXXXXXXXXXXXXXXXXXXXXXXXXXX
