-E-E--------B--E-X---------o-----------------------------B-----------------------------------?-M---B---B-------------X---------------o-------oM-----------?--?--------------------o---B---------M-------
-o--?-----------------o---------------------------------B------------------------X----------E-------------------------M------------------------------------B---o-----?----------------------------------
----B-----X---------------------------o-----X---oo-------------------B--o------B--------------------?o---B---E-M-----------B-------------E------------------------------------------------B-------------
o-----------------------o------------X------------B--B----------B----------B---------B-B--------------------------------------------------------------------?-?-----o-----------------o----------o------
------Xo-------------M------------------------o-----o-E-B---------------o-----------Eo?----X----------------BB----E-----------o------------M----------------------------?---------B?--o-----------------
------------B---B-------o--o?---X---------------o-----B-X----------------------?------o-o--X-------------------------B-o--E--------o--------B--M-------------------------------B-------------B----?-----
--------o--------B----------------B--------------B----------------------B--------------o----------------------o---------------------?---B-o-B?---?-------------?-----o-----------?-B--------------------
------o--------------o----o------------o------------------M------------------------o-------------------------B-B--------------------X----B------------ooM---o-----------------------------------X--X---v
------o-o--------------B------------------------------------X----B?----B-------------o---?---o------B------o------------------------------X--B--oM-------------------------------o----------------------
-o--------o---o-------------B-----B---------o-----------------B-B-----------o-----------------o------o--------------?-------o----------------------?--o--o--------B--------B------------------------B---
B------------------------o--------o--------o-----------B---o-------------------------------------o-----B----?---------------o-----------------o---------?---o----------o--E---o-----------------o-------
----oo-----o-------------------M----------------------E----------o-------M-T-------------------o-------------o--?--Eo---------------------X------o-------------------?----M--XB--------o--------B-------
-B------------------E-----------------B------B---?----o-----E-o----------?------o---o--B--XX-E-------------------------------o--------?--E---|--------------------M-------------------B-----------------
-------------------------T---X--M?o-------|----------B--o-------o---------B|--T------B-----------------------------o------------------------------?--E-------------B-----------B--------------B------o--
m-----B---------------?--------------------------------o------?-M-?--------M---------B--o-o------------------------------X------o----?-------|----------?------------o----------B-------o--B------------
XXXXXXXXXXXXXXXXXXXXXXXXXXXXXXXXXXXXXXXXXXXX-BMX-X-XXXXXXXXXXXXXXXXX-XXXXXX-XXXXXXX?XXXXXXXXXXXXX-XX?X?XXXBXXXXXXXXXXXXXXXXXXX-XXBXXXXXXX-X?X|X-XXXX?XXXXXXXXBXXXXX-XXXXXXXXXXXXXXXXXXXXXXXXXXXXXXXXXXXX
