-X------------------------o----B-?M-----------o-------------------------o----------------------------X--o------X---------------------------?---------X-o-B----B--------?------B------E-oB--o----------o-
--------o------B-------------------------------?--o-------------o----B-----------------E-----------o--------------o------------------------------o-------?--------------?-------------------------------
-B----?---o-----------------B------B---B----o-----E--------------ooo----------------------------------------------o--o--o-----------------E------E-----B-----------?-------B---------EM---------o-----o-
------oo------------------B----o--------------o-------B-----BM-E-----B---------------------B-B---?------------------o-----------M---------B-o---X--------o-------E----------o---------------------------
----------------o-oo--o----o---------o-----B---------------------BX----------------------o-----------X--------------------B-----------------------??----X-----B-----------B---------o----B----E-o--B---o
-o--M-?----------------------o------------B---X--------oBo--o----------E--B-----B-o----o---------------E-?----------------------------------B----o---------B---------------B-------------------------B--
--B---------------E-----------o-----------BB-----------------------o--------------------o--?-----E-------------M-------o--------B--------------ooE--------B----X--------o-------------------B-----------
-B-------o---------Moo-----X-----------o---?---E----o-BB-----------------o--o---o-----------o-----------------------o----o-----o--?-?---------o------X---------------oo------B--------------o--o-------v
----------------------------------------------------o----------B--o-----------------------------X--------X-------Xo-------------B----------o?---o-----o------o-----------------------------------XB-M--o
--B---B---------o------------------------------------------------o--o----B------B---o---------------------------------oB------------------Bo-----------o-----------------------E-------------o----------
-o--------------B--?---------B----------?--------o---------------?-----o----B----------B------------------B-----------E----o-----T------B----ToE---------B---o--------Bo-B------o--------------------?--
o------ETo---------o---X------------o-----B-------|------------------------E--------------o------------------------------oEo--o----T----o--o-----------B---B----o--------E------------------X------X----
-----T-o|------o---------oB---------------------o-|------------------oE--o-----------------------o-------M-------------------B---|-o--------o|B---------?-----------B------o---o--------------B-o-------
-----|-?|--------------X---o-----------------X----|----o---------o-X---E----B----------o------------------------X------------E--o--|-------------------?------o--o---------X----o-T---------EE----------
m----|-E|----B----o-----o-B--------------o------oX--oX--o--------------o--o--------|---------BE-------------------BX-------B?----|-----------|-----------------------o----E-------|-----------------XT--
XXXXX|XX|XXXXXXXXXXXXXXXXXXXXX-XXXXXXXXXXXXX-XXXXX|XXX-X-XXXXXXXXXXXXXXXXXXXXXXXXXXXXXXXXXXXXXXXXXXXXXXoXXXXXXXXXXXXXXXXXXXXXXXXXXX|XXXXXXXXXX-XXXXXX|XXXXXXX-XXXXXXX|XXXXXX-XX-XXXX--XX-XXXXXXXXXXXX-XX
