------------------------------------------------------------XXXXXXX-------------------M------------------o----------------------------------------------------------X-----------------------------------
----------M-----------------------XXXXXX----------------------------------------------------------------------?-------o---------------------------------------------------------------------------------
----------------------------------------------------------------X---------------------------------X---o---------------------------------------------------------?---------------------------------------
---------------------------------------------------------------------------------------------XXXX???????-----B---------------o-------------------o------------------------------------------------------
-------------------------X-----o-----------B------------------------o--BBBBBBB----------------------B--------------------------------------------B-M-----------------------------????-------------------
--------------------------------------X-----------------------------------------------------------------------------------------------------------BBB---------------------------------------------------
-------------------------------------XX--------------------------------------???????B---------------------X--------------B---------------??--------------?----------------------------------------------
---------------------------o--------XXX------------------------XX----------------------o-----------------XX-----------------------------------?--------------------------------o-----------------------v
-------T-----------T---------------XXXX------------------------XXXXXXXX-------------------------M-------XXX-------------------------------------------------------o------------------------------------f
-------|-----------|--------------XXXXX-----o----o-----------------------o-----------------------------XXXX----------B-----------------T----------------------------------T----------------------------f
-------|-----------|o------------XXXXXX---XXX---------------------------------------------------------XXXXX----------------------------|------------------?????-----------|----------------------------f
-------|---------B-|--X---------XXXXXXX-------------------------------T-----------------M---T--------XXXXXX----------------------------|----------------------------------|----------------------------f
-----?-|-----------|--XX-------XXXXXXXX---------------------XX--------|--------------------M|-------XXXXXXX----BBBBBBBB----------------|----------------------------X-----|----------------------------f
-------|-----------|--XXX-----XXXXXXXXX-------------------------------|-----------T---------|------XXXXXXXX-----TT-----------------X---|M---------------------------XX--XX|----------------------------f
m------|-----------|--XXXX-E-XXXXXXXXXX------------E-E-o-------------E|-E----E----|-------E-|E----XXXXXXXXX--E--||???E???--------------|----E-----------------------XXX--E|----------X----------------oX
XXXXXXX|XXXXXXXXXXX|XXXXXXX-XXXXXXXXXXXXXXXX---X---XXXXXXXXXXXXXXXXXXX|X--------XX|-------XX|XXXXXXXXXXXXXXX----||XX--XXXXXXXXXXXXXXXXX|BXXXXXX--XXXXXXX---------XX?XXXX--|----XXXXXX--XXXXXX----------X
