---------------------------------------------------------------------------------------------------------------------------------------------------------X-------------------------------------------X--
--------------------------------------------------------------------------------------------------------------------------------------------------------------------------------------------------------
--------------------------------------------------------------------------------------------------------------------------------------------------------------------------------------------------------
--------------------------------------------------------------------------------------------------------------------------------------------------------------------------------------------------------
--------------------------------------------------------------------------------------------------------------------------------------------------------------------------------------------------------
--------------------------------------------------------------------------------------------------------------------------------------------------------------------------------------------------------
--X-----------------------------------------------------------------------------------------------------------------------------------------------------------------------------------------------------
--XX---------------------------------------------------------------------------------------------------------------------------------------------------------------------------------------------------v
--XXX--------------------------------------------------------------------------------------------------------------------------------------------------------------------------------------------------f
--XXXX--X---------------------------------------------------------------------------------------------------------------------------------------------------------------------------------------X------f
--XXXXX-------------------------------------------------------------------------------------------------------------------------------X----------------------------------------------------------------f
--XXXXXX-----------------------------------------------------------------------------------------------------------------------------XX--------------------o-------------o------o----------------------f
--XXXXXXX----------------------------------------------------------------------------------------BBBBB------------------------------XXX----------------------------------------------------------------f
--TXXXXXXX-------------------------------------------------------------------------------------------------------------------------XXXX---------------------------------------------------------------of
mE|XXXXXXXX--------------------------------------E--------------------------------------------------------------------------------XXXXX----------------------------------------E--------------E--------X
XX|XXXXXXXXXXXXXXXXXXXXXXXXXXXXXXXXXXXXXXXXXXXXXXXXXXXXXXXXXXXXXXXXXXXXXXXXXXXXXXXXXXXXXXXXXXXXXXXXXXXXXXXXXXXXXXXXXXXXXXXXXXXXXXXXXXXXXXXXXXXXXXXXXX--XXXXXXXXXXXXXXXXXXXXXXXXXX-------XXXXXXXXXXXXXXXX
