--------------------------------------------------------------------------------------------------------------------------------------------------------------------------------------------------------
--------------------------o-----------------------------------------------------------------------------------------------------------------------------------------------------------------------------
------------------------------------------------------B-------------------------------------------------------o-----------------------------------------------------------------------------------------
--------------------------------------------------------------------------------------------------------------------------------------------------------------------------------------------------------
-------------------------------------------------------------X------------???-------------------XXXXX---------------------------------------------------------------------------------------------------
---------------------M--------------------------------------XX--------------------------------------------------------------------------------------------------------------X---------------------------
-----------------------------------------------------------XXX---------------------X---------------------------------------------------------------------------------------XX---------------------------
----------------------------------------------------------XXXX--BBBBBBBB------XT--XX-----------------------------M--------------------------------------------------------XXX--------------------------v
-??------o-----------------------------------------------XXXXX---------------XX|-XXX-----------------------------------------------------------------------??????--------XXXX--------------------------f
---------------------------?-----------?----------------XXXXXX--------------XXX|XXXX------------------------------------------------------------------------------------XXXXX--------------------------f
-------------------------------------------------------XXXXXXX-------------XXXX|TXXX-----------------------------------------------------------------------------------XXXXXX--------------------------f
------------------------------------------------------XXXXXXXX------------XXXXX||XXX--------------------------------------------BBB-----------------------------------XXXXXXX--------------------------f
-----------------------------------------------------XXXXXXXXX-----------XXXXXX||XXX---------------------------------------------------------------------------------XXXXTXXX--------------------------f
------B---------------------o------T----------------XXXXXXXXXX----------XXXXXXX||XXX--------------------------------------------------------------------------------XXXXX|XXX--------------------------f
m---------------E-----------E------|---------------XXXXXXXXXXX---------XXXXXXXX||XXX-----------------------------------------E-------------------------------------XXXXXX|XXX--------------------E-----X
XXXXXXXXXXXXXXXXXXXXXXXXXXXXXXXXXXX|--XXXXX-XXXXXXXXXXXXXXXXXXXXXXXXXXXXXXXXXXX||XXXXXXXXXXXXXXX------XXXXXXXXXXXXXXXXXXXXXXXXoXXXXXXXXXXXXXXXXXXXXXXXXXXXXXXXXXXXXXXXXXX|XXXXXXXXXXXXXXXXXXXXXXXXXXXXXX
