-------------o--B-----------o-----------------------------------o-E-----o---o--X-------o-E-----------?----------------------------B-------------------BX--o------------X---------o---o--------M---o-----
o--?--B--------X--------E---E----------------o----------------------B-o-----------X---M-------------o------BX-----M------------o---------B----------------M---------B---E-o--o------------------o-------
-------------------------------o-------------B------?X------o-o------o-o--B-----------o------------X----?------M--B----------Eo------------------X----B------------------------X------------------------
------------------E-----o--o-----o-oo-------------------------X-----------B----BX-------E---------o--------------------M-----------------------------------------------------------E-----B----?---------
--------------------?--oo-BX---------Bo-----------o--E----EE-----o-----X-------------------------B-----------M--o-----------B----------------B--B-----------M-B--------------B-------------------E--o---
------E-------?--o----------o----B--------B-B-o-----B--------------------------B----o----------------------o-XB--------------B-----------------------M-----------?X----------------------M-----------B--
----o-------------o-------------------------B------o-----------------o------X-----?-------o---B---E-------------------------B-o---------------M------o-B-o--------------------Eo---XBE---X-B------------
-----------------------X-----oB---B------o--B----------B-------X------------o----EX----?-----B--------------o-----------------o--B----B-----------?o---X--------------------------------------------?--v
---X------?-------o----E----------------B-------------------?--B-------M----o---------------------------------o--------------B-o-----B-B-------B-oo------------oB-------o-----------------------------o-
-------------------------------------MB--oo------B----------o---o---B------o---o-----------E-?--o----------B-------------------------B-------------------------------------X---------B--o---------------
-------------o--------EBo-o-----------------------------------------B------T-------o-----------------------?---------------o--B-E-BB-------o--------B--------------------o--E---M---B------------o------
-----E--B-----o---------o-E-----------------------------o------------------Eo-------------------------|--------o-o-----------o---?----T-------o-------o-----o------X-----E-----B----------B--o------B---
----------------------o---|------------------------------------?---------o----------------------------|--X--B-----o----?---------o----|----------------o------------------o------o------?-E--B----------
X-----------------MM------|--o-----------------------E-------E------B---E--|------------|---|----B----|----?--------------------------|---o---------B------------------E--o----o---X-o-------------oBE--
m---------------X----B-X--|--------o------------o--------------T-----------|---o--------|---|---oo----|-------E-----------------------|-------------B--o-----------------oX---B------------o-----oo-o---
XXXXXXXXXXXXXXXXXXXXXXXXXX|XXXXX?XXXXXXXXXX-XXXXXXXXXX-XXXXXXXX|XXXXXXXXXXX--XXXXXX-XXXX|XXX|XX-X-XX-XX-XXXXXXXXXXXXX-XXXX-XXXXXXXXXX|XXXXXX-|XXX-XXXXXXX-X-X-XXXX-XXX-XXXXXXXXXXXXX-XXXXXXXXXXX-XX-XXXX
