-?---o---------?------------------------------------oB?--------------B-M-----B--E---------------------------------oo--------X------M------E--------o------X-----------------------------------------o---
-------X------B-----E--o---o-----------B--------------o------X-------------o-B-----------------------B----o-------------------------B----o--o-------------------E----B-------X-------o----o-B-o---E-----
----------o--------?-------B------------------B---------E------------------o-----oo--------------o--------B----------------E-E-B-----oE-E-------------------------------B-----------B--------------o----
----------B------o---oo--M-----------------------X---XB---------B--------------E--------o---o----------------------------B---o-o-----------o----------o---------------------------o--B-------------o----
------------------------------X--------------------------------------------B----------B----------------B-o---o---------------------------------?---BE--------o-------o---o-----------o----o-----o------B
-----------------E----------?--------?----------X------B-----------------------------M-o-?-----------------------------EE-o--------------------------?------------------------------------o-B-------B---
-----?----M-------B------o---------------------Bo--------------------------------------o---------o----Bo--------X-----?---?-Bo---------X------------B------------------B--------B----------------------o
--M---o------------------------------------------Bo-o-------------?---------------o---------------------------------------E-BE---E-----------B-----o--X--o---------M--------------o-------o-----------ov
--o------------o---------------------?-o--B----------------------------B-----------------------?-------B---E------B--E-M-------------B---?B---------------E---------o------o---------------B------------
------------------o-B----o--o------------------M------E-----B--o----------E---o------------------------X--------o--------------------o----B----o---M-------o-o----XoB----B-----------------------------o
----------o----?----------------------------------------T---------B----------------------o-----------------o------o--o---------------X--o---------oB----M--------------------o-oB---o-------------------
-------B-------------X---------------E-------o-----o---o|---------?------------o-o-----------------------o------------M-?-----------o---------------E-o---------?B---------o-------o--M-----------------
---M------------------------o-?-T-----o-----------o-o---|-o--------------M-----------------T----------------------X------Bo--------------X------oB----o--------o----------E----------M-B----------------
--o-o------------------------?--|-------X---B-------oMo-|--------X---------------o-T-------|B--Mo------------------------------------------M-----------------E-BXo------B-o----------------------o------
m------------B------------------|-?------?-----o--------|---------------------o----|-------|o---------B---------------------o-------------E----------o---------o----X------E---------------o------------
XXXXXXXX-XXXXXXXXXXXXXXXXXXXXXXX|XXXXXXXXX-XXXXXXXXXXXXX-XXXXXX-XXX-XXXXXXXXXXXXXXX|XXXXXXX|XX-XXXXXXXXXXXXXXXXXXXXXXXXXXXXXXXXXXXXXXXXXXXXXXXXXXXX-XXXXXXXXXXXXXXXXXXXXXXXXXXXXXXXXX-XXXXXXXXXXXXX-XXXX
