---B---o-o------BB-----------------------------------o--------M-----------oo------o-------------------ooMo------------B----B--o---M---B-----B-----------------------------------------------------------
-----B--------o--------------------o-B------------o---Bo--o?--------------o-------------M-o--------o-o---------------o----B------------------M-------------X----o-o-o---------------oB--------o--o------
------oo------------------------------------------------o--------------------------------------------o------------?------------BEo-----------------o-------B-------------o------------o------------B----
-----------------------------------------------------------------------------------------------o-?------------------------------------E-------?-------------------------------E---o-----------------?---
---oo--------XB-----------------------------------------E---o-----------------o---?----------------------------------------------B-------------o--o------E---X-------------T--------------------------o-
---------B------------------B-------------o--B-----B--X------------------------------o---B-----------------------------------------?--------------X--------------------B--------------------------------
--B-----M-----o----B----------B--o-------o----------------o---E---------------------------B---------------------------o------------o-------E-------------------o-----o--o-------o-X---------------------
--------B--M-------------------------o--E--------------------------------o-------------B---B--o------o---------------------B-------o-------------B-----------?------------ME--B---M-------Eo--------o--v
---------?------o------------------------------------------------------------------------o--------------B-----------?-E-M---------o-X--o--?----------------------o--------------------o---o----------B--
---------------------------B------------X---------B-------------o------M----X-B--------------?----------o---E-------o-B---------------------------------------o----X-------------B----------------------
---B--o---B-------------o------------------BM------------------o----------o-------------------XX----------E--------------oB---------------------B------------------------------o-----o------------------
-------------------------------o-----o--o---o----------------------B-------------o--------------------------o---X----------Mo-------X---------------o--oB--------------E-------------------------------o
-------------------------------o--B-----E----------------------------------o---------BB--o-------------------B-----o-------------X----------------------------------o-B----------B---?------------------
---------B----o-----?-o--B--X--------------------M-----B--o---T---o-------E--------------------o----------------oo----------------M-o--------?---B---------B-------------M----X----------o--------------
m------------o--o--B---oo------------------------M----------o-|-------------------o--------BB------------------B-------------------------------------------T--------------------------------M----M------
XX-X-XXXXXXXXXXXXXXXXXXXXXXXXXXXXXX-XXXX--XXXXXXXXXX-XXXXXXXXXX--XXXX-XX-XXXXXXXXXXXXXXXXX-|XX-XXXXXXXXXXXXXX-XXXXXXXXXXXXXXXXXXXXXXXXXXXXX-XXXXXXXXXXXXXXXXXXXXXXXXXXX|XXXXXXXXXX-XXX-|XXXXXXXXXX|XXXXX
