-M--------------------------B----?-X-------B--------M---o----B------B-B-M---------------------o-----Bo---------o-?----M----B----------o---------------------------------o------------X-------o----------
---------o-------M------E--B?-------------------------B--o--?-----o-----------o-----o---E-M------------------------------------E--------------E------------------------------o---------------?----------
--?-----B-----o?---------E-?o---------B-----------------------------o---------------------------------------------B--------X----------o------X------E--------B-----M----------B--M----------?---------o-
------------M-----------------o-X---B-M----------M-MB-------o-------?----o------?---------------------------B---------B------M-B-----------------------M-Eo-oo?------o------------Bo-------B------------
---o----------------------------------------XX-----------------------E-?--?------------------B---------------------o--B-------B----------B--?B---oE-------X----M-o--------E-----------------------------
----o---o-B----o----------------B---------------o--B------------B---?----------M----------B-?-----------------------o-----------------?----------------B------------------?-----B-----------------------
-----E--M----B-o--------B----M--------------------X-------?-?------M-------------------B----------X----------------oo---------------------------------------?o--------------------o----B---------MB-----
--------?B-------------------------o---?-------M------------o--?----------B------------------------M--------M--------B---------?B--------------M---o-----------M-----B-------o----------?--o-----B-----v
----?----B-B---?E-------B-B-----------------MX-------B--B-----------------------------------------BB-B?B-----o----------M----------B-----------?------------B-----------E--E----B----B------------------
--M-?-M-------------------o------------B----?--------------------------------B-------------B-----------o--o-----X---------?-------------M------------B---B--------M------B----oB----M----EB------B--?---
----------------------?-------E-------E--------E-?-----------------B------M---B-B--?---------B----------------------------o--B--------Bo-o----B-----M--------------------------o-----------------T------
--------------------o---------------?-o-B---------B--------------?-E--|--|---------------B--------o--B----------o-------o--B--------------B----------o------------------------o------M-B------B--|------
--B--B---------------o------------------?o------?------E---------?---B|--|------B-----------------|-----------------------?o-------------?------BB----------------oBBB-------------------B-------|------
-------Bo---?----B---------------------M----?----M--------o----oM---B-M-------------------o----------------o------X-----o------B----B----------BM-----------------------M------M-----------------|------
m----------------o-E-------------------Eo------oo----o----------------|--|M----?---------TB-------|--------B--|---------o--------X---X---------MT-B-----?-----XE-----------------------------M--B|E-----
XBXXXXXXXMXXXXXXX-XXXXXXXXXXXXXXX?XXXXXXXX-XXXXXXXXXXXX-XXX-XX?XXXXXXX|X-|XXXXXXXXXXXXXXX|XXXXXXX-|XXXXXXX-XX-|XXXXXXXXXXXXXXX-X-XXXXXXXXXXXXXXXXXXXXXXXXXXXX-XXMXXXXXXXXXXXXXXXXXXXXX-XXXXXXXXXMXXXXXXX
