--?----------------o-X--------E------------X---B----------B--X----o---------------------o------------o------------------M--oo----B-------------E--------------X-----B-----------o------------------B----
--------------M----B--------------------------------------------------------------------------o---------B------o---B----------------------------o---M--------------------oB---------o-------------------
---------E---B------------------o----------o------------------------------------o----------------o-----------------------o----------------------------B-----------------B-------------------------------
oE---------------B---------oB--------------------o-------M------------o-----------o-----------------------------------------------------------o--B--B-B-----E----X-----------------------B--------------
-------------B-B--------------------------------------------o-----------------B-----B--------------------------------------B--oE--------E-------------------B----B--------------------------------------
-------BM--------E---------------------------------------------------------B----X-----X--------o--------------------------------E----o------------o----------------Bo-------B-----B--------M------------
-----B------o-------------X-----B-----------------------------------X---------------M------------------X-----------------o------------o---------------------X----B------------------o------oB----X------
--------oo-----o------------------B----------------------------------------------------o---------------------o--?---------Bo----------------------------------------------------o------------------o---v
-XM------------------------B-----------?-------X-------------B-------------------------------------------------B-----------------------------X--------------o--------------------X-------------B--------
--------o----------o----?-----------------------------------------o----------X---------------E----------------o--------E---------o-----------------B------o---------?--------o-----?-----o-B------------
--------B------?----?---------------------------------------------------------------------------------o----------------------------B-------------o---------o------------------------Bo-----o---------B--
--------------------B----------------------X---------------------B-B--------------?--------B----------------------B-----------B----B-|---------------------X-X---------------o---B------o-o--X----------
------------o------M-o--------o-------EE--Xo--M?--------o----------o-----------------------------o------B-X-----------------o-B-------?-------------B-----------------B----------o----------------------
---------------------B---------------------------------B----------------M-----|---o----------------B-M-----X------T-?--------?M-----B|-------E-E----------------------------------o-----------B---------
mo-E----o-------?-B-----M------------------------o---------------------o------|-------B-----------------o---------|------------------|--o--------------------------------E--BE-M------------------------
XX-XX-XXXXXXXXXXXXXXXXXXXXXXXXX-XXXXXXXXX-X-XXXXXXXXXXXXXXXXX-XXXXXXXXXXXXXXXXXXXXXXXXXXXXXX|XXXXXX-XXX-XXXXXXXXXXXXXXXXXXXXXXXXXXXXXXXXXXXXXXXX-XXX-XXXXXXXX-XXXX-XXXXXXXXX-X-XXX-XXX---XXXXXXXXXXXXXXX
