---------o--------------o-------------------o------------M----?------------------E-----B----------------?-----------B--??M-o-------B--------oo-----------o-----B----------------Boo---------------------
B----o-----X----oo---------------o--------B------?--------------------ooE-X----E-o----------------------Bo---------------oo-o---B----o-Bo-o--B--------------------Xo----------------------------B-E-----
-------------------------------------o------------M-------------------B---------B----------------------oo---------------------B-------o----------?----o---?-----o----------------------o---------------?
T-X--X-o----oo-------o-------------o-o---X-----------o------------------E------------o---X-------------------------------------------------------------o--------o--------?--------------------o--B------
-------X-------------------------------o--------o---------o--------o--o--o-----------------------------X-------o?-------B---------------o--E----M---------X-------------EBo--------------------------o--
-----B--?--------o--oo----------o---o------------------------X-Xo---------?----------oB----------B--E------o--?----o----------o------B-------------B---o--o-----BB--------------o--o------o-o-----------
---------------------------------B--B-------B-----o---M------------?--o----------o------o-------------E-o----------------E--o-?----------------------------B---------o-----o-------E-----------------BE-
--?--o-----B----------E?-----------------oB----o---o----X------X----B------------------B-B-----EB------------------------E-B---------B----E------?-----------o--E--o------BB-M---oB-o------------B-?-o-v
-----o------X---------------------------------------------------o-----------------o-M--o----------------------o------?----------------------------E------o-------X-o-------o---------------?----------B-
-------B-o------------o--X-B--------o---B------o-o--o---------o--------BB?--o---------------o---------B--------------------------------------?--o---------------------------------------------M------o--
--?---------------------------------------o-BE-------M---------------------------------------------oE-----------------T---------------------------------------------o-------------B---------------------
------------------------X---------B--------------------------------o-----------------o-X-----o-------------------T----|--E-------o---------------------------oT----E---X----T-------o--o-------------o--
--------------o--Eo---?-------o----------B--------------?o----------------o--------------------E---o------?------|----|---------------------------------------|----BB----oo-|-------o------------------B
----------------o-----------o--------------o--o-----B----------------B--?---M----B--------?---E--------------M-o-|-T--|------?o-----o--------E----------Eo----|--o------M-o-|---------------------BB----
mM--o----oB-----?--------------o----------------------------o--------o-----------o-------------------------o-B---|-|--|---------?--------oo-------------------|-------------|-X-------------------------
XXXXXXXXXXXXXXXXXXXXXXXX-XXXXXXXXXXXXXXXXXXXXXXXXXXXXXXXXXXXXXXXXXXXXXXXXX-XX-XXXXXXXXX-XXXXXXXXXXXXXXXXXXXXXXXXX|X|XX|XX-XXXXXXXXXXXXX-XXXXXXXXXX-XXXXXXXXXXX|XXXXXXXXXXXXX--XXXXXXXXXXXXXXXXXXXXXXXXXX
