---------------------------o----B----------------oB------------B--Bo-------o----o--------o-?---------------------o-------M-----------B---------B------------------------------------------------------T-
------------------B------------------------------o------------------o---------------------------E----------B---o--------B---B--------------------------------o-----?-o------?-----------------------o---
----------B--------------o--------------?------------B------E------B------?-E----B-o----------------B----------------------------------M--------------o--------M?---X---------------------B-------------
----------------------B-------B----o-----------------------------X---B----------------------M------------B---------o-------??------oX--o--------?------------B----M--o--------------------M-----------o-
-------------M---------?------------o--B--o-B-------------------------o---------Bo---------o----?--------------o------B-----o--------?---------------B--------------------------------------------------
-o?-B---------X------o-------------B----B-------------------?-?--Bo-------------------o------------M--------------------B---------o----------------------------E-------o------------------E-B----------o
--o-------------------------------M-o-------------------------B--o-------B---o----?---o-?-----------o-o-----------o----------------E----------------------oB------o--B---------------B---------------M--
-----------------------?-----o-------?-o-X-B---------o-----------------------E-------M--------o----o-----------B-----------B-M----?-------B-o-?-------------------E--X----------B---M-----X-----Xo--o--v
--------B-----------------X-----o---------M---X---B-o----M---------B----------------------------------------B-----o----------o--------o-------------?X-o-------o--------o-----------o---------------o---
------M------------------------o---------------B--------------------M?------------o---------------------?--------------------------------------------------o-----?-B--------o------------------M--------
---------?-------------------------------B---T-----T-------------E------------------------B--B-----------B---------------------------M-----------------o---?-B-------------B-------?-------T------------
--B------o---o-----------------------B-BB----|-----|-------------??-------------o------------------------------M--------X--?-o-B---------o----T----------------B----------------B----------|----?-------
----?X-?--?----------------------------------|-----|-------------------------------------o-----------M---X--o------o----B--------M----------------------?------o-----o--T-----X-XX--o------|--------o---
--o---E--------?------o-o-----o-?---------?B-|-----|--E-------------------o-----o-----E----------------------------oB-----o------------------o|-------------------------|o-?------------o--|-o---------?
m---E---------E-------------------o--------|-o---------B--------o---o-o------o--------------EB----o---------------------------------o---------|E-----Eo-----------------|---o----?-----o---|------------
XXXXX-XXXXXXXXXXXXXXXXXX-XXXXXXXXXXXXX?XXXXXX|XXXXX|XXXXXXXXXX-XXXXXXXXXXXXXXXXXXXXXXXXXXX-XXXXXX-XXXXXX-XXXXXXXXXXX-XXXXXXXXXXXXXXXXXXXX-XXX-BXXXXXXX-?XXX-XXXXXXXXXXXXXXX-XXXBXXXXXXXXXXXXXBXXXX-XXXXX
