-------E----------o----------------------B-------?--o-------------------------o--X---------o---M--------------B--------------------o------E----X----------B---------------------------------------------
--B-----------?----o------------------------------------------------o------------o----------M------o----------?-Bo---------------B-o---E------------------------E?---------o---------------------------o
----------------------------X--o---------------------------------------------o-----o----------------o-------------------------o------------------------------?----------B----------?---------o--E-------
----o----------------------E-------------------------B-B-E----------------------------------------B-----------------------------o--------E----------------M-E?----------o----------------------------?--
-----------------------------------X------------o------------B----------------------------X-----------o----------oX-oX----------------o----B---------o--------------B-B--M-o--------E----o-E-----------o
---------?--o-------------------------------o----------Xo--o-----------X--------------------EB-----------------o---B----------------X----------o-B-----o-----o---X---------------------X--------M-------
----E-?--B-------------------o-----o-----------------------------------o----E----------------o?--B------o--?-----B------------------------?--X-----B---------------X---------M--------------?---------o-
---------------------------------M---------------B-?----E----------o-----------------E-----------o-------o------o---o----------------M-----o---------?-----------------------------------------o---oB--v
-----------E--------------------M-B-----------------------o------------------------------E-------E-o-------B---------------o-B-----------------------------o----B-------B--------X----------------------
-----------------------------------------B--------------?------------------B-------o---o-----------------o------------B-------------o----------------?------o------------B--------------?---------------
-------B-------------o------------------T----------B------------------------B-------------------------------o--------------?---oE-----o----------------E-----------------o----------T-------------------
-----------o----------------o--------------BE------------o----------o--o--------?------------------o----TE--o---|----------------E--------o---------------------------------o-------|------o------------
----------X-------------B----------?o---|----------B--------------X-o|-----o-----------------o|-------------M-o-o---------o----------------B------------------------------------------------------------
--o--------o--------------------------o-----------o----------------B-----M----MB-------o----------o-----|-------|--o-----------------------B----------o-----------------------o-----|-o--?o-------------
m---------E---E-------?---?---------------o----------------------------T---------------------o--o---?---|B------|-------?---o---------E---------------------------------------------|----B---?---Bo-----
XXXX-XXXoXXXXXXXXXXXXXXXXXXXXXXXXXXXXXXX|-XX-X-X-XXX-XXXXXXXXXXXXXXXX|XXXXXXXXXXXXXX-XXXXX-XXX|XXXX-XX-XXXXXXXXXXXXXXXX-XX-XXX-XXXXXXXXX-XXXXXXXXXXXXXXXXBXXXXXXXXXXXXXXXXXX-XXXXXXXXXXX-XXXXXXXXXXXXXXX
