------------------------------------------------------------XXXXXXX-------------------M------------------o----------------------------------------------------------X-----------------------------------
----------M-----------------------------------------------------------------------------------------------------------o---------------------------------------------------------------------------------
----------------------------------------------------------------X---------------------------------------------------------------------------------------------------------------------------------------
---------------------------------------------------------------------------------------------XXXX???????-----------------------------------------o---------------------------o-----------------X--------
-------------------------X-----o-----------B------------------------o--BBBBBBB----------------------B--------------------------------------------B-------------------------------????-------------------
-M------------------------------------------------------------------------------------------------------------------------------------------------------------------------------------------------------
---------------------------------------------------o-----------------------------?--B---------------------X-------------XB---------------??--------------?----------------------------------------------
---------------------------o------------------------------------X----------------------o-----------------XX-------------------------?------------------------------------------o-----------------------v
-------------------T-------------------------------------------XXXXXXXX---------------------------------XXX--------------------X-----------------------------------------------------------------------f
-------------------|------------------------o---------------------X------o-----------------------------XXXX-------------------XX------------------------------------------T----------------------------f
-------X-----------|o---------------------XXX-----------------B--XX-----------------------------------XXXXX------------------XXX------------------------------------------|----------------------------f
-------XX--------B-|-----------------------------BB-------------XXX---T-----------------M---T--------XXXXXX-----------------XXXX---------------------------------------BB-|----------------------------f
-------XXX---------|----------------------------------------XX-XXXX---|----T---------------M|-------XXXXXXX----------------XXXXX------------------------------------------|----------------------------f
-------XXXX--------|------------------------------------------XXXXX---|----|------T---------|------XXXXXXXX-----TT--------XXXXXX---X--------------------------------------|----------------------------f
m---B--XXXXX-------|-------E--------?--------------E-E-o-----XXXXXX--E|-E--|-E----|-------E-|E----XXXXXXXXX--E--||???????XXXXXXX-------E---------------------------------E|-E-------------------------oX
XX---XXXXXXXXXXXXXX|XXXXXXXXXXXXXXXX-XXXXXXX---X--------XXXXXXXXXXXXXX|X---|----XX|-------XX|XX-XXXXXXXXXXXX--XX||XX--XXXXXXXXXXXXXXXXXXBXXXXXX--XXXXXXXXXXXXXXXXXXXBXXXXX|XXX-------XXXXXXXX-------XXXX
