------------------------------------------------------------XXXXXXX-------------------------------------------------------------------------------------------------X-----------------------------------
----------M-----------------------XXXXXX------------------------------------------------------------------------------o---------------------------------------------------------------------------------
--------------------------------------------------------------------------------------------------X-------------------------------------------------------------?---------------------------------------
-------------------------------------------------------------------------------------------------???X???-----B---------------o-------------------o------------------------------------------------------
-------------------------X-----o-----------B------------------------o--BBBBBBB-------------------------------------------------------------------B-M-----------------------------????-------------------
--------------------------------------------------------------------------------------------------------------------------------------------------BBB---------------------------------------------------
-----------------------------------------------------------------------------???????B---------------------X------------------------------??--------------?----------------------------------------------
---------------------------o-----------------------------------X-----------------------o-----------------XX-----------------------------------?--------------------------------o-----------------------v
-------T-----------T-------------------------------------------XXXXXXXX---------------------------------XXX-------------------------------------------------------o------------------------------------f
-------|-----------|-----------------------------o-----------------------------------------------------XXXX-------------------X--------T----------------------------------T----------------------------f
-------|-----------|o---------------------XXX-----------------B---------------------------------------XXXXX----------------------------|------------------?????-----------|----------------------------f
-------|---------B-|--X--------------------------BB-----------------------------------------T--------XXXXXX---------o------------------|----------------------------------|----------------------------f
-----?-|-----------|--XX------------------------------------XX-------------T---------------M|-------XXXXXXX----------------------------|----------------------------X-----|----------------------------f
-------|-----------|--XXX--------------------------------------------------|----------------|------XXXXXXXX-----T------------------X---|M---------------------------XX--XX|----------------------------f
m------|-----------|--XXXX-E------------------E----E-E------------E--E-----|-E--------------|E----XXXXXXXXX-----|-???E???--------------|----E-----------------------XXX--E|----------X----------------oX
XXXXXXX|XXXXXXXXXXX|XXXXXXX------XXX-XXXXXXX---X---XXXXXXXXXXXXXXXXXXXXXX--|----XXX---XXXXXX|XX-XXXXXXXXXXXX--XX|XXXXXXXXXXXXXXXXXXXXXX|XXXXXXXXXXXXXXXX---------XX?XXXX--|----XXXXXX--XXXXXX----------X
