--------------------------------------------------------------------------------------------------------------------------------------------------------------------X-----------------------------------
----------M-----------------------XXXXXX----------------------------------------------------------------------------------------------------------------------------------------------------------------
----------------------------------------------------------------X---------------------------------X-------------------------------------------------------------?---------------------------------------
-------------------------------------------------------------------------------------------------------------B---------------o-------------------o------------------------------------------------------
-------------------------X-----o-----------B------------------------o--BBBBBBB----------------------B--------------------------------------------B-M-----------------------------????-------------------
--------------------------------------X-----------------------------------------------------------------------------------------------------------BBB---------------------------------------------------
-------------------------------------XX------------o-------------------------????????---------------------X--------------B---------------??--------------?----------------------------------------------
---------------------------o--------XXX------------------------------------------------------------------XX-----------------------------------?--------------------------------o-----------------------v
-------T-----------T---------------XXXX------------------------XXXXXXXX-------------------------M-------XXX-------------------------------------------------------o------------------------------------f
-------|-----------|--------------XXXXX-----o----o-----------------------------------------------------XXXX----------B-----------------T----------------------------------T----------------------------f
-------|-----------|o------------XXXXXX---XXX---------------------------------------------------------XXXXX----------------------------|------------------?????-----------|----------------------------f
-------|---------B-|--X---------XXXXXXX----------BB--------------------------------------------------XXXXXX----------------------------|----------------------------------|----------------------------f
-----?-|-----------|--XX-------XXXXXXXX---------------------XX-----------------------------M--------XXXXXXX----------------------------|----------------------------X-----|----------------------------f
-------|-----------|--XXX-----XXXXXXXXX-------------------------------------------T----------------XXXXXXXX-----TT-----------------X---|M---------------------------XX--XX|----------------------------f
m------|-----------|--XXXX-E-XXXXXXXXXX------------E-E-----------------------E----|---------------XXXXXXXXX-----||???E???--------------|----E-----------------------XXX--E|----------X----------------oX
XXXXXXX|XXXXXXXXXXX|XXXXXXX-XXXXXXXXXXXXXXXX---X---XXXXXXXXXXXXXXXXXXXXX--------XX|XXXXXXXXXXXXXXXXXXXXXXXXX--XX||XX--XXXXXXXXXXXXXXXXX|BXXXXXX--XXXXXXX---------XX?XXXX--|----XXXXXX--XXXXXX----------X
