--------------------------------------------------------------------------------------------------------------------------------------------------------------------------------------------------------
---M----------------------o------------------------------------------------------------------o-------------------------------------------------------------------------------------------------o--------
-------------------------X------------------------------------------------------------------------------------------------------------------------------------------------------------------------------
--------------------------------------------------------------------------------------------------------------------------------------------------------------------------------------------------------
-------------------------------------------------------------X------------???-------------------XXXXX---------------------------------------------------------------------------------------------------
---------------------M------------------------o-------------XX--------------------------------------------------------------------------------------------------------------X---------------------------
-----------------------------------------------------------XXX---------------------X---------------------------------------------------------------------------------------XX---------------------------
----------------------------B-----------------------------XXXX--BBBBBBBB------XT--XX-----------------------------M--------------------------------------------------------XXX--------------------------v
---------------------------------------------------------XXXXX---------------XX|-XXX-----------------------------------------------------------------------??????--------XXXX----------------------XXXXf
---------------------------------------?----------------XXXXXX--------------XXX|XXXX------------------------------------------------------------------------------------XXXXX--------------------------f
-------------------------------------------------------XXXXXXX-------------XXXX|TXXX-----------------------------------------------------------------------------------XXXXXX--------------------------f
------------------------------------------------------XXXXXXXX------------XXXXX||XXX----------------------------------------------------------------------------------XXXXXXX--------------------------f
-----------------------------------------------------XXXXXXXXX-----------XXXXXX||XXX---------------------------------------------------------------------------------XXXXTXXX--------------------------f
----------------------------o------T----------------XXXXXXXXXX----------XXXXXXX||XXX-------------M------------------------------------------------------------------XXXXX|XXX--------------------------f
m-------------------E-------E------|---------------XXXXXXXXXXX---------XXXXXXXX||XXX----------------------E------------------------------------------------E-------XXXXXX|XXX----------------E---E-----X
XXXXXXXXXXXXXXXX------XXXXXXXXX----|--XXXXX-XXXXXXXXXXXXXXXXXXXXXXXXXXXXXXXXXXX||XXXXXXXXXXXX---------XXXXXXXXXXXXXXoXXXXXXXXXoXXXXXXXXXXXXXXXXXXXXXXXXXXXXXXXXXXXXXXXXXX|XXXXXXXXXXXXXXXXXXXXXXXXX-XXXX
