------------?-BB--B-?E-?---B--------------------------------o-B------------------B-------o--------------------o-------------oEB-------o---------??-------------------o-----E----------------B-----E-B---
------------oo-----------------------BB---------?----o-------o----------------o-----o---BB------o----------------o----------E--------o----------------------oo--------------EE--------------------------
-------------------o------------o?----M----?------------------------B-------------oM--B-------------?---B-------------------------M------------Xo------------------X---B--o------o----------?-----------
E-------o----E-------B--B-----------B---------oB--?-------------------------X------B-------?---------o--------E---------------------------M---E---------------------------Bo--------oMo-----EM----------
---M?----------o-------------oB?----------------M------------------o----------------------B--------o---------M-----Bo---------------------------------o--------------X-----------------o-------oBB------
-------B----------B-----------------E--?---------E--------B--B------o------?----------------------Bo----?---o---E--------B--o----------?------------------B-?---B---------M----BB--B--B------B------?---
----B--------B-------------?------------------------------?----BB-------M--B---------B-----------o---------o--------X----------------B------o-------------B------------?BM-------------?----------------
------?---------M-----X-----?--o----o---B---------------------?-------B----B--------X-----------------------------oo----------------------------o------------E----------------------M---BM--------E-B--v
------------?-----------------------------------o---------------B----o---------X----------E-oo--B-------------------o---------B----------------------?--o--------oM--B-------B----B---------------------
--------------M-----B-M-----M--Bo-------------------?----M?--o----------BB--------------?-------------B------?-------------o-----B-----o---B------?-------B--------o----------B-------------------------
--B-----------BM-oM------o--M----------------------------------o-----o---------o--------B-----o----X--o----oB----M-------B--B-o-----------------M--?-----------------o-------o-------o-----------B-M----
------------o-----X------??---BTo--------o--o-------------------------------------?----------------------------B-------M---o-----X------X----------B?-o---------o---B--o---E---E-----------B------------
-----B-------------o--------o--|-o--B-----B--XBo-------------------E------------BT---------M--BBB-------|--------------------B---E--------X-----o------Mo?-----------M-----|T--o--MB--------o-----------
---------------?---B-B---------|------?--------o-----M--------------M-?|----M--o-|---------------------B|-------------X--BX------------?--------T---------M------X---------||---o----------?---X--------
m---o-----?B--?----------------|--------------------o--B-o-----B---------------B-|----------M---------o--|--------B----B-----M---------------o--|----------------------X---||-------E-------X---------B-
XXXB?XXXXXXXXXXXXXXXXXXXX---XXX|XXXXXXXX-XXXX-XXXXXXXXXXXXXXXXXXXXXXXXX|XXXXXXXXXXXXXXXXXXXXXXXXXXXXX|XXXXXXXXXXXXX-XXXXXXX-XXXXXXXXXXXXXXXXXXXBX-MXXX-XXXXXXXXXXXXXXXXXXXXXXXXXXXXXX-X-XXXXXX-XXXXXXXXX
