---------X---------o-----------------o-------o--B----------o--------?--o-----------B-----o-----------------------------------B----------------------------B---------o-----?---B--?----B-----E-----------
--o-oE----------------?o---o-----------X---o-M-------B---------------------------X?B--------------o------M------B---o-------o-X----------Xoo-E---E-o--------B---o--B----------------B---------E---------
----X-----o---------B------------------XB-------o-----------------------oB----------Boo---B---M----------------------oE------B-o------------------B-------Xo----------------E----------------o----------
------o------o-----o---o---o----o-------?XM-----X------?-------o------X-------------B-------E-------------M-----o--X------------o------o---o------------E----------o----------o-----------------------E-
------X------?----------M---------------------X----------------E--------?--------------o---?-----------B------------o---oo-----B------------o-----o-o-B-------------------B--o------B--------o------E---
------o---------------E------X-----------------------------------X---------o-----o-----------X--X----o-------E----o------------------E--B?--M-B-E----o-----------------o---------------X----------------
--o--X----------------X-------?----M---oX-------------------------------B-------------------------------o------B------------o?-o--------B-o-B---oE-o------?B-------E-o---------------B---------------?--
-----------------------------------------------------o-------?--------o---------?B------------------------------M---?------------------------------EE------------?---o---------B----------?----------o?v
-------------?------------------------M-------?----------o-----------------------------B-----o----------------------o-----------B-----M------------Bo-----------B-o---B-E--------------BM---o-----------
------X---------o----B-------E----------------------Boo----X----------o--o-----B---B-------o-------------------o-------------o--B------?-----------oX------o---------------o-oB----------M-----B-o-M----
--------o---B--------------o-------------o-B------------?--T--------------?-----------o-----------------------M--oE------------B------------------------------o------------------o----------------o--o--
----------------o----o--?----o----o-o---o------------------|--------------------------------o-------------E---------B--------o---X-----B--o--E-----------------o--------------------oB-------B----------
---B-o---B------oo------B--------------------------------o-|-M-----X-------o-----o---oo-------B-----------------o------------o---------------------B--------o------B-E------X----ME---B-o--------------X
---B-o--------------------------------------------------B--|B-----------------B------o-----------------T--E-------Bo--X--M-Mo-----------------B-------oo-----------E-B----------B----o?-----o-----o-----
m------------o------------------------------T---X---------X|?--o-------------------------------------B-|--o-----------------------------------o----M-----X--o----------------?EB------------------------
XXXXXXXXXXXXXX-XXXXXXXXXXXXXXXX-XXXXXXXXXXXX--XXXXXXX--XXX-|XXXXXXXXXXXXXXXX-XX-XX-X-XXXXXXXXXXXX-XXXXX-XXXX-XXXXXXXXXXXXXXXXXXXX-XXXXXX-XXXXXXXXXXXXXXXXXXXXXXXX-XXXXXXXXXXXXXXXXXXXXXXXXXXX-X-XXXXXXXX
