---------------------------------------------------------------------------------------------------------------------------------------------M----------------------------------------------------------
-------------------------------------------------------????????--------------------------?--------------------------------------------------------------------------------------------------------------
--------------------------------------------------------------------------------------------------------------------------------------------------------------------------------------------------------
--------------------------------------------------------------------------------------------------------------------------------------?????-------------------------------------------------------------
----------------------------T--------------------------------------------------------------------------------------------------------------------------------------------X------------------------------
----------------------------|-------------------------------------------------------------------------------------------------------------------------------------------XX-------------------T----------
---------------X----X-------|-----------------------B-------------------------------------------------------------------------B----------------------------------------XXX-------------------|----------
-------------------XX-----BB|BBBB-------------------------------------------------------------------------------------------------------------------------------------XXXX-------------------|---------v
------------------XXX---T---|-----------------------------------------------????-------------------------------------------------------------------------------------XXXXX-------------------|---------f
-----------------XXXX---|---|-------------------------------------------------------------B-------------------------------------------------------------------------XXXXXX--------????????---|---------f
---------o--o---XXXXX---|---|------------------------------------------------------------------------X--------X-----------------------?----------------------?---M-XXXXXXX-------------------|---------f
---------------XXXXXX---|---|--------------M-----------------------------------o-----------------------------XX---------------------------------------------------XXXXXXXX-------------------|---------f
--------------XXXXXXX---|---|-------------------------------------------------------------------------------XXX--------------------------------------------------XXXXXXXXX-------------------|---------f
-------------XXXXXXXX---|---|----------------------------------T------------------------------------------XXXXX-BBBB---------------------BBBBBBBB---------------XXXXXXXXXX--????-------------|-----T---f
m-----------XXXXXXXXX---|---|--------------------------------E-|------------------------------------------XXXXX-----------------------------------------X------XXXXXXXXXXX-------------------|----E|---X
XXXXXXXXXXXXXXXXXXXXXXXX|XXX|XXXXXXXXXXXXXXXXXXXXXXXXXXXXXXXXXX|XXXXXXXXXXXXXXXXXXXXXXXXXXXXXXXX--------XXXXXXX-------XXXXXXXXXXXXXXXXXXXXXXXXXXXXXXXXXXXX-XXXXXXXXXXXXXXXXXXXXXXXXXXXXXXXXXX|XXXXX|XXXX
