o-------B------M-?--B----B-----E--------E-----?--?-B-------X----------------------------?-------B------X-M-ME-B-------?---------M--o--------------------B-E--E--?----------------------BM--------------o
--------?-----------B------------X-------------------------X-XE------BB?---------------------B--ME----M-----------E-----------M--------o-----------B-B-----------------E-B------------B--X------------T-
-------------------------------------------------------X----BBM------------B--E--------------------------?-----B-B--------E-------------o------B----M-E------B------------------B------B----?--B---E--|-
---B---B---B------------------------------B-B---o-X-o--------------X---------?-M------B----B------?-----E?----------------X----o-X---M-----?------------B--------------------?---B----?-------B--M----|-
-------o--X-----B----------E----X-?-B----B--------------?-----------------B-----------------B----------------------------??------?---------?------E----E--X------M-----?----B--B--?----------------?-E|-
---?---X------?---B--Bo---------E----M-----?-----B----B----?------X-----------------------T-----------------------oBB-o--------------?---o-------------M---------E-o-----ooB------X-------------------|-
XX---?-o-----------?-----B-----X---X---------??--------B-----B----T-?-TB--M-------------B-|------E-------?-----?-E---E---------------------------X--B-------o----------------------X-B---XEo-X------o-|-
----E-B----o---------------------------X--M--------o-B------------|---|-------------------|---E--------X--X-M-E----M------------?--------X--B----------------------B--B------?----------Xo------------|v
----B------B-----EB--oB-----E-----------T-----------E-------B--B--|---|--------------B----|-B----?-B--E----------X---------B------B---------B-----------------------o---------E-----E-?---------------|-
----------E-----------------------------|-----------E-------TM----|---|-----B----------X--|o-B----B-E---------B-T-----T--------------E-X---------?--E------B-----------?-------------------B--B------B|-
--------B-?-------------B--------B------|----EB-------------|-----|-o?|---E-------T-------|----------T?-------?B|-----|----EB-X-------------------B---------------------------o--B--------------------|-
B-------BoE----o--------------------E---|-o-M----B-------o--|-----|---|-o--X-E----|-------|-------B--|-----X-E--|Bo--B|---B-----Eo----------------------o--o---T------E-o---E----------o---------?----|-
-T-------B--o---------------------o-----|-------E-----------|----B|---|----------X|-------|----------|------o---|-----|--------------------B-----M-------------|---?-----------E-----o---B----X-------|T
-|-T--o------?------M-------------------|--------------o---B|-----|---|--X------EX|-------|B------?--|----------|-----|-o--o------B--------X-?-----------------|----B-B-------------B----o---------B--|-
m|T|---?--------B-BE----o-----T---------|o-----------------B|B---X|---|--X-B--E---|-------|--------B-|-E----TX--|-----|----------------M--------B-B------------|----o-?----------EB----------------E-o|-
X|||XXXXXXXXXXXXXXXXXXXXXXXXXX|XXXXXXXXX|XXXXXXXXXXXXXXXXXXX|XXXXX|XXX|XXXXXXXXXXX|XXXXXXX|XXXXXXXXXX|XXXXXX|XXX|XXXXX|XXXXXXXXXXXXXXXXXXXXXXXXXXXXXXXXXXXXXXXX|XXXXXXXXXXXXXXXXXXXXXXXXXXXXXXXXXXXXXX|X
