------------------------------------------------------X--------------------------------------------------------------------------------------M------------------------------------------o---------------
-----------------------------------------------------------------------------------------?--------------------------------------------------------------------------------------------------------------
----------------------------------------------------------------------------------------------------------------------M---------------------------------------------------------------------------------
----------------------------------------X---------------------------------------------------------------------------------------------------------------------------------------------------------------
----------------------------T------------------------------------------------------------------------------------------------------------------BBBB-----------------------------------------------------
----------------------------|----------------------------------------------------------------------------------------------------------------------------------BBBBB-------------------------T----------
---------------X----X-------|--------------X--------B--------------------------------------------BBBBBBB----------------------B---------M----------------------------------------------------|----------
---------o---------XX-----BB|BBBB------------------------------------------------------------------------------------------------------------------------------------------------------------|---------v
------------------XXX---T---|-----------------------------------------------????-------------------------------------------------------------------------------------------------------------|---------f
-----------------XXXX---|---|-------------------------------------------------------------B-o-------------------X-----------------------------------------------------------------???o????---|---------f
------------o---XXXXX---|---|------------------------------------------------------------------------X--------X-XX--------------------?----------------------?-------------------------------|---------f
---------------XXXXXX---|---|--------------------------M-----------------------o-----------------------------XX-XXX--------------------------------------------------------------------------|---------f
--------------XXXXXXX---|---|-------------------------------------------------------------------------------XXX-XXXX-----------------------------------------BBBBB---------------------------|---o-----f
-------------XXXXXXXX---|---|------------------XX--------------T-------------------------------------------XXXX-XXXXX--------------------BBBBBBBB????----------------??????-????-------------|-----T---f
m-----------XXXXXXXXX---|---|--------------------------------E-|-----------------------------------------EXXXXX-XXXXXX-----------------E--------E-------X-----------EE----------------???----|----E|---X
XXXXXXXXXXXXXXXXXXXXXXXX|XXX|XXXXXXXXXXXXXXXXXXXXXXXXXXXXXXXXXX|XXXXXXXXXXXXXXXXXXXXXXXXXXXXXXXXXXXXXXXXXXXXXXXXXXXXXXXXXXXXXXXXXXXXXXXXXXXXXXXXXXXXXXXXXX-XXXXXXXXXXXXXXXXXXXXXXXXXXXXXXX--X|XXXXX|XXXX
