-------------------------B------o---o--?B-o--------B-----o----------------------------------------?------B-------------?---------Bo--------?-------B-----B------o-B-----X--M-------oB-E---------------oB
-------------B---------------------?--------------------------------?-----------E------------------?--o------X-----------?----B--------B---------------B------------------------?------------E-----o----
-------------X--E----------------B------------B-------o-----B-o------o------------------------------o-----B-B-----------------o-----X------------MB-----o--------Bo---o--X--------------M--------?------
E-------------------o--X----o------------------?----B------B---M-------------------------------X?------?-----BB--------------------------------------o------------?-------------------------------------
------B-------?-------o-----------------X----------------MX-o-------------------B-------------B--------o-------------------B-o----------B-------o----Bo-----------E-BB-----------B---------------------M
-MB-------B---------------o----M--o------------B--oB-?B------------------------------------o----o----------------------------XX--------------oB------X-----B---o----o--X----------o---------------------
----?----E-------------------o---X------------B-----------------B-------BB---o----------------------?------B--------------o-BB-------------------------------o--o---------------------------------------
-----------B---------o------B----------B-----M-B--------------B---------B----?o-------B----o?-----X-----M-o--------B----------------E-----------B-M-B--------------------------?--------Bo-------------v
---------------------------------o-------------------------------------B-------------o------------------------------B------o--------o-----B----------------B-------------o------------B---o--------BB---
---B-----------------------------?--------o-----------------------o-----------o------B----------E--------o----------------E---X-?---------------o--------------o-o--B--X--------B--?------o---BX--------
-o------?-E----------B------o------------o-------------E--oo------M------------------------------------------------------------Xo--M--------o------------------------------X-?------------o--------o----
----------------------------?---o------o---o---------?----------------|------B-?------------------------------?-----------------------B-------B----B----------------------------------?----o----Boo-----
------------------M------------------------o---o----------------------|---------------o---------------------B-o---------------------------------?-------------------------------o----------M------------
---------------------?--------------------------M-------------B-o-----|---------------B-----------------------------B----------BE-----------------B--------B---B--|-----|-?------------B----------------
m---B--------------B----B-----------BoB--------E--------------------o-|--?---------------B------B------------------------------------------o---------B------------------------B--|----------------------
XXXXXXXXXXXXX?B-XXXXXXXXXXXXXXXXXXXXXXXXXXXXXXXXXXXXXXXXXXXXXXXXXXXXXX|XX-XXXXXXXXXXXXXXXXXXXXXXX-XXXXXXXX-XXXXXXXXXXXXXXXXXXXXXXXXXXX-XXXXXXXXXX?XXXX?-XXXXXXXXXX|XXXXX|XXXXXXXXXXXXX|XXXXXXXXXXXX-XXXX
