------B---XM--------------------B---B--------------------------------?--------BX----E--B-----------B---------?---o---------------------o----------------B-----?----------?----B-----?-------------------
----------------------BX-------B-?-------------M-o------------o--X-----------X-M-----------M--X--?o--------------o-----------------B--------B--o---X---?------------------------------?-----------o-----
--B----o--------------B-------o------oo-------------------E-------------------------------------------------------------o----?--------B----o-----M-------------------------B---o----o----------B--------
--------E----o?Bo--o-------------M--E--o-BB----o-----------------------------------B----------B-----B-------------oo----o-----?----B----------------XM---B--------o----------------XM-------------------
--M--------B-----B--------------o?X----------o---?----E------B----------o---------------o-------------------?-----------o-------E-------------B------o--?M---?-----------------------B-----?B---?-------
-B----------o-------o--o--B----o-----------M----B-----X--------------B--------------------------------------------------o---o-----------------B----------------------B------o----------------o---?--E---
----M?------X------M-------B-------------B-o-----B----------B---------?-o---B-----------M--o---?-----B-------------?-----------Mo---X-------------B-----------------------------?-B--------X------------
-----o--o---------o------o-M-----o-----------------o----B---o----------------------------B---------------------o--?----------------o--------B--------------M----Mo-?----------------B-----X---------B--v
---?X-B-B--------------B------B------M-----B------------X---Bo----?--------o----------------B-----B----------?B-------B---B--------?o---B-----------X--------o-o-oE-----------Bo------------------------
-----o----------------X----B---X-------B-o--B---------M------------------------------o--------------o--o-------?-------------B--o-----B-----------------------o------?-------?---------------B----BB----
-------B-----------------o----o-----------------o----?E---MM-T----------------------------B------B---------------------?-o--o-o-------X-------M------------o--------T-o-o--------------o-----o----o-o---
-------------------M--------------X-------B-------------o--o-|--------------M------X---?--M-o------------M-------o--------o-B----------------B-B---------B--o-------|-------------M--------B------------
o---------------------------------------------------o----B------?-----------M----E---?o---Mo--?--B-----o-----------o------------------T---M---?--------?-----o------|-----------------------------------
---o--------------------------?--------------B-----------------------------B-----------o-----B-------o-------------X-B--------B-------|---------E--B----o-----------|------o--o-------?--?-------T-E----
m-------T--------------o-o--B-----------B--?---|-?----B-----?-?------------------------------o--o--B-------B--?------o-----E-------------B--?---o----?--Bo-B-----B--|---B-------BB---Bo----------|-M----
XX?XXXXX|XXXXXXXXXX?XXXXXXX-XBXXXXXXXXX-XXXXXXXXMXXXXXX-XXXXXXXXXXXXXXXBX?X-XXXXXXXXXXX-XXXXX?XXXXXXXXXXXXXXXXXXXXX-XXX|XXXXBXXXXXXXXXXXXXXXXX-XXXX|XXXXX|XX?XXXXXXXXXXXXXXXXXXXXXXXXXXXXXXXXXXXXXXXXXXX
