---------o------------o----------------------------------------o------------o-B------oB------------------------------BB---o----------?M--B----------M-----------------o---------o------o-------oo-------
--?-----------------X--?-------M----X-------------o-----B------------B-----------B------?-------------E----------------B---------------------?--o------?-----------o-------------?-B----------?------B--
---B-?---M-B-o-------------E--o-o----------------M---------o-----M-o--E----------o----------------------------------------------------------BB------M---X----------?--------------BM-B-B--------o-------
-------Bo------------------------BB--X----------B--M--------B--o------M--------------B--------?--------------------B----------------?----X---B------------------B----------?----------------------------
-------?---?--o--------?o---------B-----M-----o------------B-----Bo------------B--M-----B---?---------?-----?---o----M-------------------E-B--------o----B-B-Bo----X-------------------------B---o------
-------B------B----M-M---------B----------B------------------o---X--------M-------------B?-o-----------------------M------------M----------E?--------------B-------B-----oE--o----o-B-------------M--M--
--------------X--B-o--?--o-------------------B------------?---oB--o---o------------------------------B----o---E----o-?---o---------M-----o-------B-------B------E----B---o-------------------o----------
------o-----?----------B---EM----------------B------B-----------------------B------------B---X-----o---o--------??----B--------------B-?--?---o--------------M---?--M---o-----------B---------------o--v
-Eo-------?--o------B----o--------------------?-B---------?---o-o--o------------------------------------o---??---M---------------B-B------E-X--o----o-----o-----B----------------M--o------?------------
-o--------M----------B---o--?----------o-----------------------------B----?---------E-----?-----------o---------------------B---------------B--?-------oM--B----?------M---------M--------------o-------
---------------------------o-X--o-------B------B---B-X------?o-----------M-X---?-----------------?----------------------B------B----X-----XB----o----------o-----B-o-o-----?--Xo--------B---B-B---------
---M-----?----------M?--------|-?B-------------------X------o-----------------------X-----------o---o--------------------o-T-o---------------------------------B-----------M----------o-------------B---
--T-----o----------------o---------------o-M-----------------o---?----------B---------B------------------------------o------------------B-------o-----|----------------?-o---o---------------o-T--------
--|------?------------------o-E-------------------B-o---------------o------o----M------B--------------?---------o----------|------------B--M---Bo----?--------------o---o------------------Bo--|-o------
m-|-----------?-------?-----B--------------------o------------------------X---o-----o----?-------------------------------o-B---------|o-----------------------BB---o---------------------------|T-?-----
XX|XMXXXXXXXXXXXXXXXX-XXXXXXXXXXXXXXXXXX-MXXXXXXXXXXXX-X-XXXMXXXXXXXXXXXXXXXXXXXXXXXXXXXXXXXBXXBXXX-XBXXXXXX-XXXBXXXXXXXXXXXXXXXXXXBXXXXXXXXXXXXXXXXXXXXX|XXXXXXXXXXXXXXXX--X-XXXX-XXXXXXXXXXB?XXXXXXXXX
