----------------------B---------------Xo-----B----Mo-----M----------E--------------------------------------B----MB------------------------------o----------o------------------Mo--------------oX--E-----
-M--oB------X--------------------------M------B------------------------------------------X--B------?----o------o-----M---------------E-------?----------------------------------------------------------
---------o------------------?----------M------------B--o?--X--M------------B---o------B----------------B----------M--------------------o---o--B-----------------------------------------------B---------
-----B--?--X-----------B-----------o------------------------?--------B?--X-o----------------X-------------B-------------B-----B--------------X-------o--------B------B--X---E----------------------X---o
-?--------B----------?E----o-o-B--o---------------------M--------------?--o----------------------------B---o-o--------------B-------------E------?-------------o-----M-----?-------B-?------------------
-----------o-B--B---------o-------------------o-------------o-------------E----------o--?--------o---------------------------?------B----------B----------oB-----------E------o-E-----o-------E---------
-------------------E------B----------B-------------X-------------B---------o---------E-?------------------B------------------------------------------?----E----?------M---B------M?--B-X----o----B------
-------X--------------E--------------------Bo-------------o-----------------o------o---o---------------------------------------------------o-------?------------------------M------B-------B-----------v
-------B------------------------?--?-------------------------------------------------------------------o-o----------------?-----------------B--------M--------?----o---------o------------------M-------
---------B------B-----B----------?--------?-------------------?--------------B--------B-----o-----o--B---o-?-----B----------------------B--E-----------------------------B?-----o------?--o---M---------
------------------B---------------------o---------------X--o-----o-------------------------------------B------------o--------E------o------------o---------------o------------X-----E-------------E----E
--------------------BM------EB--o--------?------------------------------B--------------?-o---|------------------T--------------B-------------T------E---------------------------------------------------
--------------M---B-------------M--------B-----------------------------B------M--------------|B-----------------|--------o---E?--------------|-----B----o--o-------------oB-------?------------------B--
----------o----------------------?--------------M--------B-o-o-------B-----?----X-B----------o-------------XM-------------------------------B-?------?---------?-----T---------------o-----------o------
m----o---B------B------o-----o---B---B---o--oo-----BB---------------------------B------B-----|----o--o----------|------------------B---------|------BB----------o--------------------E---o-X--o---o--X--
XXXXXXXXXXXXXXXXXXXXXXXXXXXXXXXXX-XXXXXXXX-XXXXXXX?XXXXXXXXXXXXXXX-XXXXXXXXXXX?XXX-XXXXXXXXXXXXXXXXXXXXXXXX?XXXXXXXXXXXXXX-XXXXX-XXXXXXXX-XXXXXX-XXXXXXX-XXXX-XXXXXXX|XXXXXXXXXXXXXXXXXXXXXXXXXXXXXX|XXX
