---EMo-------------------?----o---------o-o-------B-------M-----------Bo-------------------E-------------------X----------B---E------------------------------------------------B-------------X----------
-------------?--------------------B------------M-------------B------------------B---------------------------B-----------------------?---------o---------------------B-----X-------?----o----------------
---?---B---Bo-o-------------o----o----------B-------------------?---------------------------o----------------B----------------o----------o---------B-B---------?-B---------oo-B-------------?-X---------
------------o-Mo--M-BB-----o---------------X-----M--?------------------------B--o-----------o---------------------o------B-----------?E---o-------------Eo--------o---------------B----o--?-------------
o---------B---X--------B--B-------------B-----oBB------B---------------o------------------?------M-------------X---------------------?B-o-------------------------M---------------------------B---------
---------------------------------o----o---------------o--------------------------------o--?-X-------------------------o----------o-----X-o----------------B---------------------------------o-----------
---------------------o---o-----------o----------------------------------B---------------o-----------------------Bo----B--------o?--------B---X-----------X------B---------B-------------B---------E---o-
----o--B---------o--------o------X----------------o---------B--------------------B---X-?------?-----------------------------o---E-------------ME-----------B-----M-----B---------o---------------------v
------------o----------------o-X-----------?-o---------------B---------M----------M--------o-B----------B--------?--Eo----o----------B--------------------B---B-------B--o-----oB-------BM?----------o--
---------o--------------------B------------E--------BM--------B-?--------------------B----o----------B--------?--------o-E-------------o------E------B-----------------B--------------------------o-----
BB?--o-----------B--?-o-----------X---o------B------------------------------E-oB-----MB-------------E--?--------B-?-----------?B---------------?----------------------------B---------o-----------------
---B---------------------------------o--o----------------X-BB--E--------------------------------------B----------|----------------------------?-?--------------------E-----B------------------------B---
---------------oo------------------------------------T-----------oo--?-o---------Bo-----o-------------o|---------------------EEB----?--o------------------B----------------?----M----B------------------
--M--------------------o------------------------?--?-|--------B-------o---------Bo--------B------------|--B--B-Eo---------------o--?--------------o-----------------?--B--------BB--B-TX-------?B-----B-
m----B---------------o-E-----------------------------|------------o---------o-----------XB-------------|------B-?o-------------------------------------------B-------M----------------|-------XB------o-
XX-XXXXXXXXXXX-XXXXBXXXXXXXXXXXXXBXXXXXXXXXXXXXXXXXXX|XXXXXXXXXXXXXXXXXXXXXXXXXMXX-XXXXXXXXXXXXXXBXXXXX|XXXXXXXBXXXX-XXXXXXXXXXXXXXXXXXMXXX-XXXXXXXXXXXXXXXXXXXXXXXXXXXXXXXXXXXX-XXXXXXXXXXXXXXX-XXXXXXX
