------------------------o-----------------------------------XXXXXXX-------------------M------------------o----------------------------------------------------------------------------------------------
----------M---------------------------------------------------------------------------------------------------?-----------------------------------------------------------------------------------------
----------------------------------------------------------------X-----------------------------------------------------------------------------------------------?---------------------------------------
---------------------------------------------------------------------------------------------XXXX???????-----B-----------------------------------o---------------------------------------------X--------
-------------------------X-----o-----------B------------------------o--BBBBBBB----------------------B--------------------------------------------B-------------------------------????-------------------
-M------------------------------------X-----------------------------------------------------------------------------------------------------------BBB---------------------------------------------------
-------------------------------------XX------------o-------------------------???????B---------------------X------------------------------??--------------?----------------------------------------------
---------------------------o--------TXX------------------------XX----------------------o-----------------XX--------------------------------------------------------------------o-----------------------v
-------------------T---------------X|XX-----------------------------------------------------------------XXX-------------------------------------------------------o------------------------------------f
-------------------|-X------------XX|XX----------------------------------------------------------------XXXX----------B-----------------T----------------------------------T----------------------------f
-------X-----------|o------------XXX|XX---XXX-----------------B---------------------------------------XXXXX----------------------------|------------------?????-----------|----------------------------f
-------XX--------B-|------------XXXX|XX----------BB-------------------T-----------------M------------XXXXXX----------------------------|----------------------------------|----------------------------f
-------XXX---------|-----------XXXXX|XX---------------------XX--------|--------------------M--------XXXXXXX----BBBBBBBB----------------|----------------------------X-----|----------------------------f
-------XXXX--------|----------XXXXXX|XX-------------------------------|-----------T----------------XXXXXXXX------------------------X---|----------------------------XX----|----------------------------f
m---B--XXXXX-------|---E---E-XXXXXXX|XX-------E----E-E-o----------E--E|-E----E----|-------E--E----XXXXXXXXX--E----???????--------------|----E-----------------------XXX--E|-E-------------------------oX
XX---XXXXXXXXXXXXXX|XXXXXXXXXXXXXXXX|XXXXXXX---X---XXXXXXXXXXXXXXXXXXX|X--------XX|-------XXXXXXXXXXXXXXXXXX--XXXXXXXXXXXXXXXXXXXXXXXX-|-XXXXXX--XXXXXXXXXXXXXXXXXX?XXXX--|----XXXXXXXXXXXXXX----------X
