--------------------------------------------------------------------------------------------------------------------------------------------------------------------------------------------------------
---------------------------------------------------------------------------------------------o-------------------------------------------------------------------------------------------------o--------
------------------------------------------------------B-------------------------------------------------------o-----------------------------------------------------------------------------------------
--------------------------------------------------------------------------------------------------------------------------------------------------------------------------------------------------------
-------------------------------------------------------------X------------???-------------------XXXXX---------------------------------------------------------------------------------------------------
---------------------M------------------------o-------------XX--------------------------------------------------------------------------------------------------------------X---------------------------
-----------------------------------------------------------XXX---------------------X---------------------------------------------------------------------------------------XX---------------------------
----------------------------B----------------X------------XXXX--BBBBBBBB------XT--XX-----------------------------M--------------------------------------------------------XXX--------------------------v
-??------------------------------------------------------XXXXX---------------XX|-XXX-----------------------------------------------------------------------??????--------XXXX----------------------XXXXf
---------------------------------------?----------------XXXXXX--------------XXX|XXXX------------------------------------------------------------------------------------XXXXX--------------------------f
----------------o--------------------------------------XXXXXXX-------------XXXX|TXXX-----------------------------------------------------------------------------------XXXXXX--------------------------f
------------------------------------------------------XXXXXXXX------------XXXXX||XXX--------------------------------------------BBB-----------------------------------XXXXXXX--------------------------f
-----------------------------------------------------XXXXXXXXX-----------XXXXXX||XXX---------------------------------------------------------------------------------XXXXTXXX--------------------------f
----------------------------o------T----------------XXXXXXXXXX----------XXXXXXX||XXX-------------M------------------------------------------------------------------XXXXX|XXX--------------------------f
m-------------------E-------E------|---------------XXXXXXXXXXX---------XXXXXXXX||XXX----------------------E------------------E-----------------------------E-------XXXXXX|XXX--------------------E-----X
XXXXX-----XXXXXXXXXXXXXXXXXXXXX----|-XXXXXX-XXXXXXXXXXXXXXXXXXXXXXXXXXXXXXXXXXX||XXXXXXXXXXXX------XXXXXXXXXXXXXXXXXoXXXXXXXXXoXXXXXXXXXXXXXXXXXXXXXXXXXXXXXXXXXXXXXXXXXX|XXXXXXXXXXXXXXXXXXXXXXXXXXXXXX
