---------------------B--------------------------o--------E--------B--o------o---E-B-o---------?-?---------M-----------------X---B--------o----------------------o-------------o--------------o----------
-E---o---B--M----B------------------o-o-------o----------oo---------?-------o------E--------------E------------------------------B-------------o----------oX--------------------------------------------
---------B----?-----------E----oM--------------------------------o--B-----X-------M-----B--M-----o-----E-------M----o--E------------------o------------E-o-----------------------------------o----------
-----o-------------E-------------o-----o-------B-----------------------o-----------M?-o---B-B-o-------------o--B-------------------B---------o-o--X--------?-------------o------BB----------------------
-----o?-X--?----------B-M--o-o--o--------------o----o---------------------------------------------B-o-------------X--?-o-----B--------------------------------------E----------B--------------------B--M
------------Bo----E--------?-?-------------o-----E---------------------------X------o----------X-------------X---------------------B--B--o--------B-X-----------o--o----?-----B----X----o--X---o-o------
------------------B---------------------------?---B-----BB-------M?---------M-------B------------o----------o----B---------------------------o---?B-o--------o-----------------------?--B-------------o-
----------------------?-oo-----------B------ooM----------------o------------o----------------B------E--o?--B--o---------X---------------o----------------------o-----o----------MM---------------------v
--o--BE-----------------B---------------------?-B-o-----------o---------o-----B-------oo---------------X---------X-------------?-o-o--------------o---------o----------o-----------o-------------o-o--?-
---------------E---o---------------------o-?--E------------------------------X---o-X-----------------------B---o------------------o---------------B---oo--------o----o---X--M-o-o-----------------o-----
---o--X?---------------------M---o--------------o?---T---------------B--------M---o--------?--------------------------?---o--X--------------M----------------o---E---X--------B------T---------B-X--B--B
-B---------o----?o-----------------------------------|-X-------------o--E-X-------------M--------------------------------------E--------------X-o---X----X------E--------------o---B-|----B---------B---
--X-----o----oM----------------E----o----------------|-E------------B-------B--------------B-------------------------------------------------M--o---o---------X----------------------|---Bo----------B--
o------------o------B--T?-------o----B----------o----|---------------------------------------------o-------------------X--o--TB---------o----------------------Bo--------------X-----|-BB---o--T-B------
m----------------------|------o----B-?-------oo--B---|-----------------------------------------o--------oTB-o------------E---|------o------------------MBo-----------oT-o----------B-|---------|--------
XXXXXXXXXXXXXXXXXXXXXXX|XXX-XXXXXXXXXXXXXXXXXXXXXXXXX|-XXXXXXXXXXX-XXXXXXXXXXX-XXXXXXXXXXXXXX-XXXXX-XXXXX|XXXXXXXXXXXXXXXXXX-|XXXXXXXXXXXXXXXX-XXXXXXXXXXXXXX-XXXXXXXX|XXXXXXXXXXXX-X|XXXXXXXXX|XXXXXXXX
