----------------o-B--oo---o------B-------o--?------------?-E--B-EX---o----------------------------B---------------------------------------------M---------B-------------------------E-------------------
------E-----------------------------------Xo---B------E----o--------------------------------o?----------------------o---B----o-----oX-----------B----------o---------o--------------------------------B-
------------o-------X--o-------E------Xo---E---------------o---o-------o-------B-----------------------------------------------M-o---E-------?-oo--B----------------M------------------o----------------
-M----------------------------oo-o--------------E----o------X-o-o----------o-----oX--------------o--o---------Eo------?--o-------------------o---------------------------------B----------o-------------
----?---------o----o-------o-B---M--oX---o------------B---------------------------------B--o-------------B-------------------X-------------oB---------M--B------o--------X---------------?B-----------B-
--B-------------B-----o--------------B---o-------------------------X----E-----B------------------M-------------o-------------------B----o-----------------------B----------------------B---o-----------X
-----o---------------------o------X--o----B---------o---o-----o-------------o---o----------------o-E-o------X-----B-------X-----o--B--o------------X---------M-------o----E----------B-Eo-------------X?
--o-X----B-------B---------------------------o---------------------------Bo------o----------------o------------?----o-o-------------------------------o---E-------B------------------o-E-o-------------v
---------------M-----Xo----o--o--B----------------B------o-------o-------B--------?----------------X-----------------------o---?B--------------B--------------------------------?---------------o-------
------------------------------------X--------oB-------o--------M-----o--------o----------------o-X----------------------?---------o----------o-E-----------o---o-------X------o---------?--?---------o--
---------------------------------o--------?---------------o-------------M----------------E--E-o-------------------------------------M-------------------------o--------------o---o-------X--B----B------
----------------------------------------o---o---?------o--B---------B--BE--------------------M-B---BX------o-------------------------------o-------B------o--E-B-B---E-------------o-E-----------To-----
-----------o-------------o-----------B------X----------------o------------------oB-----M-----o--o-E----------------------------------E-B----------o----------------------------o-B---?-----------|X-----
-----------Xo------------o----------------------------------------BT---------?-o----------------------------------?----------B-------------------------X-o--Bo----------o----B--o----------------|M-----
m----o-------------E-----o------?-------o--o-----------------------|--------B----------------X-?----------------------------X----B----o---------o-T-o-M-------------BX----E--o--B-------o---B----|--X-BB
XXX-XXXX-XXX-XXXXXXXXXXXXXXXXXX-XXXXXX--XXXXXXXXXXXXXXXXXXXXXXX-XXX|XXXXXXXXXXXXXXXXXXXXXXXXXXXXXXXXXX-XXXXXXXXXXXXXXX--XXXX-XXXXXXX-XXXXXXXXXXXXX|XXXXXXXXXXXXXXXXXXXXXXXXXXXXXXXXXXXXXXXXXXXXXX|XXXXXX
