--------------------------o--B-------o-M-------B-----------o--------------o---X-----------?-o-----M-o---o-------o---M---M-------M-----BB-M-----X---o----M--B--------------?--------------M-?--B--B------
---------?-----o---B-----?----?------B-------oB--------B-----------M---------------------E-M------M----B-B--B------M--------?----oB-----B---E-----------B--------o--------------------------------------
----------oM---------------------oM--------------------------EB--B--------o--------------M------------------------------M---------o-------------------?--------------E--------------------?---B---------
-------------?---------B-----?-----B----o-------M------------------B---B-B-E-o?----o------------------?----------B--o----oo--M--B--E----------o----M-------o-?--X--o---------o-o------B?-----o----------
---------?-----------?------B------E--------X--X----------o--------B-E--X------B-?---B---o--------B-MB-----B--------------o-M---------B------o----Xo-------------E-------------?--?------------?--------
---o------B--E---??-----B--------------------------?o--o----?---o-----E----------------------o--------------------M-B---------------oB--------------o-----------M---------?----------B----------E--o----
------------------B----o-o----X------o-----------o-E-------B--B---------o------------B-------------------B--B------------B--B-----X--?--------------------?--------------------B---------------M--------
X-----o-----------------o---------o-B----o---B-B-o---oo-M--B?-----BB-----?------X---------B-------------------EB--B--------------------o------E-----------------o----------------?--B--B----MB---oo----v
o-----------------o----------o-B-X--B-?---------------------B-------------------------M-----------------------------o-B--------------------------------------B---M--------------------------------------
--------X------o-----------o---o-----------M--------------X----X------------------------------------M--M--?---MB---------------XB---------?---------------------------B----------------------B----------
-X----------o--------o-------o-o---------------B--------------B---o----------o-B------------E-o---------------------------?---B---------------------B---------------o-------------------B-T-B-----B-----
MM-----------M--M------------------X--o----------o-----------B----------B-------M----B--------------o-----o-----------------?--B------------M-------------------BB--------B----------?-----B-M---------o
-----------BE-o---------------------------M--?-B-o-------oB--B----B-----B----B--------T?-------------------B--------B----------o------------------------o-----------o----------------B--o-|-------o-----
---------X------o-----------------?---?--B--------o-----?-----------------------------|---X--B-------------X--------------------o---------------------------------------------o-----?-----|-----MB------
m-T--?------------------o-----------B---------------------------M-----B---------------|o--B---B-o-------------?------------o--------o------M------BM---------X----------B--------------o-X|----o-----B--
XX|-XXXXXXXXXXXXXXXXXXXXXBXXXXXMXXXXBXXXXXXXXXXXXXXXXXXMXXXXXXXXXXXXXXXXXXXXXXXXXXXXXX-XX?-XX?XXXXXBXXXXXXXXXXXXXXXXXXXXX-XXXXXXXXXXXXXX|XX--XXXXXXXXXXX-XXXXX-X|XXXXXXXXXXX-XXMXXXX-XXXXXXXXXBXXXXXXXXX
