----B------o------B-BB-------------E-----EB--oo--------o-----------oo---?--------E?o--------------------o-----E--------------------------------o----------o------X---B--o----------o------o---E----X----
-----------------B--------------------------o------------------o-o----X----o---------------o-B-------o----------oo-------B--------------------B--X?---B-------------o-----X-----------------------------
B--------------B--------------------------------o-------B-----------------------------------B---oo-----------------B--------------------X----B--------------------------------Xo-----------------B------
---?----------------o--------------X--o-------B---------o----?B---------------------o---------o-o---------------------------oo--Xo-o?------------------o-----------?-----E---o----------------o---------
B----------o---o----------o-------------------o-------oo---------------------o--------------o-------o----------o-----------o------------o----o-o-----?----------o--------o-o----------X---B-------------
---------------------------o------------------------------X------------------------------------------o--------------------------o----------------o-----o---B-----------o--B----o---------------------o--
--------------o----------E---------------------oB-----------o----------------------?-X-----------------o---------oo----M----o-------------B----------------------------------------B--oE-o-------------?
-o----------------------B--------------o----------o-----oB----o---------------------o----------E--B-o---B--------o----oo--------------------B-------?--------o-o---------o-o-------B--o---------E-----ov
-------------o---------------------o-----------o----o?-----o---------o-----B------o-M---------B----------------------------M---------B--------------------------------X-----------X---------o------o-B--
------------------------o----------o--B-------------o-o-------o--------------------------oBB---------------o-----------o------o-------------o-------------------------------X-------o----B--------------
---------?-------------E-M---------------------------o---?-----o-----o-----------------------X--T----o---------------------------------------------M-------o---------------------o---------E?-----------
-----------o-------B-----oM--E--o---Bo--o--o--------------B---o--B---------------E--------E-E---|--------------------B--------------B--------------M------------------o-----o-----?--o-------E--o-------
--o-------------o-----o-----------------------------------o--T------o-----B-----T---------------|-M------?--------------------------------------------------------------------B----o-----B---Eo---B-----
-----------------o----------?---------o-------------------?--|-M----B----M------|------?--o-EE--|-------?-----------------o-------M-------------?-----M-----o---M--?-------------o--?-------------------
m--B-----E----------?-----------------------X----------------|BB--E-------------|----------o----|--------B-B---------------------E-o------o---------------?---o-----o---------o-----o-------MM---o-B--B-
XXXXXXXXXXXXXXXXXXX-XXXXXXXXXXXXXXXXXXXXXXXX-XXXXXXXXXXXXXXXX|XX-XXXXXXXXXX-XXXX|XXXXXXXXXXXXXXX|XXXXXXXXXXXXXXXXXXXXXXXXXXXX-XXXXXXXXXXXXXXXXXXXXXXXXXXXXXXXXXXXXXXXXXXXXXXXXXXXXXXXXXXXXXXXXXXXX-XXX-X
