o---o----------o---------X----o---X---------------BB---------------------o-B-----------B----------------------------E-E--o-----o--E----------------------o-o-----?-----M-----o-oE------oo?------------B-
----?-o----M---------------o-B------------?------B---------------Mo---o-o---------o----o--X----------o---o--------E----?------o----------?oo------o------------E--X---o------?E-----B---------?---------
---X----------------------------X-----o----------------X---o------o-----------o-X--B-----------E-----------o-------------------X------o---E-------------------------B-?-----B----o--------B--------o----
-?-----------o-B------B----------------------o----------------o----------ME------------------oMB----------B---------o-o-----------o---B--------?--------------------------------------------o----------o
------------o------E-----------o----M--o--o----o--------B----------------------------------o---------B----o--E-----?o-----------------Bo-----------------------------------B-o-o---------------o-------o
o--o-----o?----------o---------------B----------------o--------B-------------B----------------oo----------------------o-------------M------------------B----------XX--------------M----B-------oo-------
-----M--o--------o----?-B----------------o------------B-----o----B----------oo-------------B----o-------------------------o-------------o------------------B---------------M-------------------o--------
---E------E--B-------o---------o---------------------------M---------o---------------?o------o---o--------X----X-----?-----M------------------B--------B---------------------------------o-------o-o---v
--o-----E-----------------------?-M---o-----M--o----------o----------------------------------------o-----------------------------o---X---------------------------o------B--------o------X-------E-------
-----------B-------o----------------M------------X------oB------------o-------------o------------------E--------o--X-----------------------------------?------------------B------B-----o----------------
B--B--X---EX----X---o---------------------E--------BX-------------o--o--o-------B----oB-------B----o-------------oB-----B---o-X--------------o-X---------B------o----XEo------------------o-------------
------o-B---?------------E-B-----------------------------|-----|o---o---------o-o----Bo---o-X-o-------o-B--------------EX--B---B---T-o-----B-T-----------------------M--?---M---o----?--o-B-T----BB-----
----------?---B----------------------B----o------o----B----BB---o----------------o------------o--------o-M----------o-----------B---------T------o--------B------------o----o---------------|-----------
-o--------E---X--o----------------------o----?--o--|-----|--o--|----------E----------?----o-------oX--BB--------o--------B---------|o--------|------------o--?--o-------Bo---------------E--|-----------
m---?----------------B----|--X---------------------|-----|--B--|---B------------------------B-------------T--------o--E------------|o--T-----|-----ooX-------------o-o--?--------------o--?-|----------o
XXXXXXXXXXX-XXXXXXXX-XXXX-XXXXX-XX-XXXXXXXXXXXXXXXXXXXXXXXXX-XXTXX-XXXXXXXXXXXXXXXXXXXXXXXXXXXXXXXXXX-XXXXXXXXXXXXXXXXXXXX-XX-XXXXXXXXXXXX|XXXX-X-XXXXXXXXXXXXXXXXXXXXXXXXXXXXXXXXXXXXXXXXXXXXXXXXXXXXXX
