--------------------------------------------------------------------------------------------------------------------------------------------------------------------------------------------------------
---------------------------------------------------------------------------------------------o-------------------------------------------------------------------------------------------------o--------
--------------------------------------------------------------------------------------------------------------o-----------------------------------------------------------------------------------------
--------------------------------------------------------------------------------------------------------------------------------------------------------------------------------------------------------
--------------------------------------------------------------------------???-------------------XXXXX---------------------------------------------------------------------------------------------------
---------------------M------------------------o-----------------------------------------------------------------------------------------------------------------------------X---------------------------
-----------------------------------------------------------------------------------X---------------------------------------------------------------------------------------XX---------------------------
---------------------------------------------X------------------BBBBBBBB------X---XX-----------------------------M--------------------------------------------------------XXX--------------------------v
-??--------------------------------------------------------------------------XX--XXX-----------------------------------------------------------------------??????--------XXXX----------------------XXXXf
----------------------------------------------------------------------------XXX-XXXX------------------------------------------------------------------------------------XXXXX--------------------------f
----------------o----------------------------------------------------------XXXXXXXXX-----------------------------------------------------------------------------------XXXXXX--------------------------f
--------------------------------------------------------------------------XXXXXXXXXX--------------------------------------------BBB-----------------------------------XXXXXXX--------------------------f
-------------------------------------------------------------------------XXXXXXXXXXX---------------------------------------------------------------------------------XXXXTXXX--------------------------f
------------------------------------------------------------------------XXXXXXXXXXXX-------------M------------------------------------------------------------------XXXXX|XXX--------------------------f
m------------E------E-------E--------------------------E-E-------------XXXXXXXXXXXXX-----------------------------------------E-----------------------------E-------XXXXXX|XXX--------------------E-----X
XXXXX-----XXXXXXXXXXXXXXXXXXXXXXXXXX--XXXXXXXXXXXXXXXXXXXXXXXXXXXXXXXXXXXXXXXXXXXXXXXXXXXXXXX---------XXXXXXXXXXXXXXoXXXXXXXXXoXXXXXXXXXXXXXXXXXXXXXXXXXXXXXXXXXXXXXXXXXX|XXXXXXXXXXXXXXXXXXXXXXXXXXXXXX
