--M-------E------B---------------o------------------------o----------M--------------o--B---------------------o---------B-------------------------------------------B-------M-----o---X-B-------o--------
T-B----------------o----------------o------------------E------B--------------?--------------------------M-----o----X?-----------------------------------XBB--------o-------E--------o------------o------
-B-----o--------------o--o--B----------------------X---------o-------B------------o------B---------------------------------E--M-----o--E--o-o----------------------------?-----M------------------------
------?------o--B--------------------X----E----------------------------------------B----o--------------------B---B--B---o?--------------------B---------o---o--------B-?--B------X---------------o------
------------------------------M---------B--------E------------------------------B------B-----------------BB-----------Xo------------------------?X------o---------o-----B---------B---------------------
----------B-----------------------?-----------------o---M-o------B------------------------BBB-----------o------------------------B--------B----o---------------oB-----Bo-------o------------------------
--o----M-----------?-----?------B---X-----X-B-M-------o-------------------------B?------o---B---------o-------M-----------------------------E---------------------------M----B---------------?----------
-o------------o--------------------B---------------B-----M-o------------B-------?---------X----------?-------------X--o-X---------B------B--------------o--B---------o------o----------------------B---v
---------------------------------------B----------------?----?------M---B--------o-------------------------------B--------o------------B-o-o----o----o--B---o----X---------------B----o----?X-----------
-------M------?------o--------B-o--------------------------------o---??------o-------E--------E-----B-----o-------o-----------------?----------------------------o-----------?---o-----------------EB---
----------X------o-----------------------o-----------------------------M--------o-----?--------------------------o------------------B--------------X------------------------E----T---------------T--?---
---------------------------X-o------o----------------o-----B--o------------o------------------oB------------------------o--------B---------E----------|--------------------------|E--B-?---------|-----?
-M---------------------B--------------o------B------------------------------o------M----o-------------------------------------------o-------------B--o--------ooE----------------|---------------|------
-------------------o---?-B---------------B--B----------------------o---------------B---------o--------------------------------BB-----X-----------------------------------TMo-o---|X--------------|--B---
m---------X-B-----------------------------------------o-----------------------------------oo---o-----------B---------o--o----o---------------E--?-----------------------B|--o----|---------------|------
XXXXXXXXX-XXX-XXX-XXXXXXXXXXXXXXXXXXXXXXXXXXXXXXX-X-XXXXXXXXXXXXXXXXXXXXXXXXXXXXXXXXXXXXXX-XXXXX---XXXXXXXXXX?XXXXXXXXXXXXXXXXXXXXXXXXXXXXXXXXXXXXXXXX|XXXXBXXXXXXXXXXXX-X|XX|XXXXXXXB|XXXXXXXXXXXXXXXXX
