----------------------------------------------------------------------------------------------------------------------------------------------------------------------------------------o---------------
-----------------------------------------------------------------------------------------?--------------------------------------------------------------------------------------------------------------
--------------------------------------------------------------------------------------------------------------------------------------------------------------------------------------------------------
----------------------------------------X---------------------------------------------------------------------------------------------------------------------------------------------------------------
----------------------------T------------------------------------------------------------------------------------------------------------------BBBB-----------------------------------------------------
----------------------------|----------------------------------------------------------------------------------------------------------------------------------------------------------------T----------
---------------X----X-------|-----------------------B--------------------------------------------BBBBBBB--------------------------------M----------------------------------------------------|----------
---------o---------XX-----BB|BBBB------------------------------------------------------------------------------------------------------------------------------------------------------------|---------v
------------------XXX---T---|-----------------------------------------------????-------------------------------------------------------------------------------------------------------------|---------f
-----------------XXXX---|---|-------------------------------------------------------------B-o-------------------X-----------------------------------------------------------------????????---|---------f
------------o---XXXXX---|---|----------------------------------------------------------------------------X------XX-------------------------------------------?-------------------------------|---------f
---------------XXXXXX---|---|--------------M-----------------------------------o------------------------XX------XXX--------------------------------------------------------------------------|---------f
--------------XXXXXXX---|---|--------------------------------------------------------------------------XXX------XXXX-----?????--------------------------T----BBBBB---------------------------|---o-----f
-------------XXXXXXXX---|---|----------------------------------T--------------------------------------XXXX------XXXXX--------------------BBBBBBBB-------|------------??????-????-------------|-----T---f
m-----------XXXXXXXXX---|---|--------------------------------E-|-------------------------------------XXXXX------XXXXXX-----------------E--------E-------|------------------------------------|-----|---X
XXXXXXXXXXXXXXXXXXXXXXXX|XXX|XXXXXXXXXXXXXXXXXXXXXXXXXXXXXXXXXX|XXXXXXXXXXXXXXXXXXXXXXXXXXXXXXXX----XXXXXXXXXXXXXXXXXXXXXXXXXXXXXXXXXXXXXXXXXXXXXXXXXXXX|XXXXXXXXXXXXXXXXXXXXXXXXXXXXXXXXX--X|XXXXX|XXXX
