-----o-------------------------------------B----------o--------------E--M------------------------M-BB------B--?----------------------X?-----B--------M-----------------X---------------o-------o--------
----------------X---------------------------M----B----------------------o-----------------------B-----------?----o-----B-----------oo----o----o------B----------------------------------E---------------
---B--------o----M----M----B-------------------B-------------?-----E----?---------------------------------------------B--------------------------B-ooE----------?o--o-------oo------------------o-------
------E------M---B-------E----------------o---------------------?X--------------------o---E---------------------B--------M---X-------------?------------------------------------------o---o---oM--------
----B---------o--o-------------B--------M------------------------------?--Moo-------------------------o------------------------------M---------o-------o--------o--------B-------M-XBo----B-------------
----------------o-----B----oo--------B--------------------B----E--EE-----------o-------B----------------------X--B--------------B-----------E-----B---?----------------------o--------------E--------o--
-------------------------------o--------------------M---------o--E---o-----?----B-----B--E-------B-BB----------------------?-----?-------------B--------o-------E---B-?-----------------------B---------
--o----------------B----------------BB------B-B-?-----B----M----BX-----B-------o----M---------------------------B?--------------o------------o------------------------------B--o----------------M---M--v
----B-o------------B-------------?----------o------------------------?-----------E---o--?----------------------o------X-----o---?---------B---B-----X--------o----------------------B--o-----------o----
------M------------------------------------------E--o---------o---------o-o--------------------------M------------o---B------------B--------------oB--o-----------------------------o-------------------
-?------------------o-----------E---------M---------------------------o---M----------------------------?------------------X-------------oE--------E----------B-------------B--------?------------------o
T-B-M--------B--------------|--------T--------?-B-----o---o-----------BB----------B---------?----------------?o----------------------o--o-----B-----B-?o----o---------------X-----X-B---o---------------
-----------------------------o------T-------------------------?--------------M----o?-----o-----------o-----------Moo----B----o--------------------?-----o-B------------o-B------B-----------------------
-E------B---------------X-----oB----|--B--------M----o----M------Eo----M--------B-B------------o---------------------------------------o-----------B----------o------------B------?o----o-------------M-
m------------T------M-?--------------|-----------------|--?-----------------------------o--------o---o------------------------------------------------o-----------------------T-----------------?-------
XXXXXXXXXX-XX|XXXXXXXXXXXXXXXXXXXXXX|XXXXXXXXXXXXXXXXXXXXX-XXXX-XXXXXXX-XXXXXXXXXXXXXX-XXXXXXXXXXXXXXXXXXXXXXXXXXXXXXXXXXX-XXXX-XXXXXXXX-XXXXXXXXXXXXX-XXXXXXXXXXXXXX-XXBXXXXXXXXXXXXXXXXXXXXXXXXXXX-XXX
