------------------------------------------------------------XXXXXXX--------------------------------------o----------------------------------------------------------X-----------------------------------
----------M-----------------------------------------------------------------------------------------------------------o---------------------------------------------------------------------------------
--------------------------------------------------------------------------------------------------------------------------------------------------------------------------------------------------------
---------------------------------------------------------------------------------------------XXXXXXX---------B-----------------------------------o---------------------------o-----------------X--------
-------------------------X-----o-----------B------------------------o--BBBBBBB-------------------------------------------------------------------B-------------------------------????-------------------
-M------------------------------------X-----------------------------------------------------------------------------------------------------------------------------------------------------------------
-------------------------------------XX------------------------------------------?--B---------------------X-------------XB---------------??--------------?----------------------------------------------
---------------------------o--------XXX------------------------X-----------------------o-----------------XX-------------------------?------------------------------------------o-----------------------v
-------------------T---------------XXXX-----------------------------------------------------------------XXX--------------------X-----------------------------------------------------------------------f
-------------------|--------------XXXXX----------------------------------o-----------------------------XXXX-------------------XX------------------------------------------T----------------------------f
-------X-----------|o------------XXXXXX-----------------------B---------------------------------------XXXXX------------------XXX------------------------------------------|----------------------------f
-------XX--------B-|------------XXXXXXX----------BB-------------------T-----------------M------------XXXXXX-----------------XXXX---------------------------------------BB-|----------------------------f
-------XXX---------|-----------XXXXXXXX---------------------XX--------|----T---------------M--------XXXXXXX----------------XXXXX------------------------------------------|----------------------------f
-------XXXX--------|----------XXXXXXXXX-------------------------------|----|------T----------------XXXXXXXX-----TT--------XXXXXX---X--------------------------------------|----------------------------f
m---B--XXXXX-------|-------E-XXXXXXXXXX------------E-----------------E|-E--|-E----|-------E-------XXXXXXXXX--E--||-------XXXXXXX-------E---------------------------------E|-E-------------------------oX
XX---XXXXXXXXXXXXXX|XXXXXXXXXXXXXXXXXXXXXXXX---X---XXXXXXXXXXXXXXXXXXX|X---|---XXX|XX-----XXXXX-XXXXXXXXXXXXXXXX||XX--XXXXXXXXXXXXXXXXXXBXXXXXX--XXXXXXXXXXXXXXXXXXXXXXXXX|XXX-------XXXXXXXX-------XXXX
