----E--o---------o-o---o--o------------B--o----------?o--------B------o-----o------o--------------B-------------------------??-------?---------o---------B--o------------------o---------B--o-----------
------M----------------------X----------------------------oo-------oM-B---------------?-----X----B----o-----o-----------E--o-----o--------o---E------o----------o----B------------------------BB--o-o---
--o-----X---B----B---------o-------------------?---------------------o---------B-------B-E---------------X-oo--------------o-B-----------oo-----------------------B------X----------ooBo-----------?----
--------------o--o----------------------------X-----Xo-o-------------------------E------B----E----X---?------o-------o-o---------------o-------E------M-------o----------------------o---?o--o---?---?--
--M----------E---------------------------------B--o--------------XX---oX---------------X--o---B---EE---------B-----X-oo-------------o-?-----------------------------------------------------------------
------------------?---------B-?---------?-----o-B--o----E--o-----o------------------------------M---------B-o---------M--------?------X-----o----B----o--Xo------------o------o----------o----------M-M-
----B---------o-----o---------X------B--o----------o----X----X-----o------------B-----X------o--------------X----------------------------------------o---------------------B-?---B-------B----------X--o
---------------?-o----B----o-------------------B---o--------BM-------oXo--------o-o-----------------------------o-------B-------B----------------------------------o-o--------------o-M-------------B--v
--------------o-?-------------E----?-------------o----E---Mo--o-------------------o--------o-----o--------------Bo-----------B-----------------------B-----------o--B--------?-o---o--------X-----------
------o---M------------B-------------M-----------E----o-----------o?-----o-----------BM----X-------------------Bo-------Bo---------------o--------------B-------------o--------B--X--------B-------B----
BE----------X-----B-M----------------------------------B------E---------B---------o-----o-----B----oo---o-----B--X-------------------B----------B--?---------------?o------?----------o-----------------
-o--T-----BB-o-------B---o---T----B-------------BB--------o-----------o-------------------o-------------------?-------oE-----------o-------B----------B---?----B---E--o-o---oo--------------------------
--o-|-o-------------------o--|----o--T-o-E--o-----o-o-----------B-----------------------B----o--o-------------B----------------------E--o-B----o--------oB--------------?oB----o---B---o--------B-------
----|o----X---------o-----?--|-o-----|------T-o------BB--B-------------------------To-------------------------------E--------o--------?---------?-o-----To-Bo-----------T------------------oB-----------
m---|-X---?o--oB---M-------o-|-o--?--|------|----E------o----o--------o------------|---------T---------------o-----------?-----o----------o----------BB-|---B-----------|o-B-E------------------o-------
XXXX|XXXXXXXXXXXXXXXXXXXXXXXX|-XXXXXX|XXXXX-|XXXXXXXXXXXXXXXXXXXX-XXXXXX-XXX-XXXXXX|XXXXXXXXX|XXXXXXXXXXXX-XXXXXXXXXXXXXXXXXXX-XXXXXXXXXXXX-XXXXXXXXXXXX|XXXXXXXXXXXX-XX|XXXXXXXXXXXXXXXXXXXXXXXXXXXXXXX
