--------------------M-------o-oX--?B----------o-------B-----------o--E---------------------B-----------?------B--?----------------?----o---oo------X--------B--B------------------------B---------ooB---
--------o---------------------o-----------------------E-B-----o---------------------X--------Xo--o-?-------B------------oo---o----BX-E----------------------------BBo-X---E-----------------------------
--------B---E---o---o?-?-----o--o--------------B----?--o------------------------------o--X---o----B--------------------o---X---o---------------o--------o---------------o--------------o--------o-----B-
-------o---o-------------------------------------------X---------------------?--------------o-----o------o---------------E-----o--------oo------------------?--M-----------o--o---o----o-------X--------
--o-----?---------B-o-------------------M----o-----X----------------------X---------B---------o--------------------o---------B------?---------o-?-?----------o----------o-------?---o-------------------
-------------------------------o-------?-------------o--o--X------B--X----------------?-----X-----------------o------E-----------------o--------------------o---o-------------o---Bo---o----------------
B--o-------------B--------------X-o-----------o--oX----E----------------B--X---------o-----oo----------------o-----X--------------o---------o--o---o----X---------------------------o-------------------
--------B---o---M-------------B--------------------------o-----------B---------?------------o----------X---M--------X-----------------------------?--o--------------------X------------------B----oX-X-v
----o----------o-----------X-----E-o---M-------------------o--------------------Mo---B---------------o------------------B---?------B--------------------E----o-------------------------------o--o------o
-------------X--------------B-E----X-----------M--B----o----X---------X---------o-B-o------------------B-------------------------o-X--------o------------------o--B-----o---B-----------------oo-E------
---E--B---------------------------o---------------M---M-------oB-M---o------o-----------?o--M-B--o--------o------Bo---o-------B-------------X----B--------------------T-B--oB----------o-X-o----o-------
-----------B------------E--?------------------------?------------o-------o--------o------------------------X--------?----------------------o--------------------------|--------------?-------------B----
---------------oM--------------o--o--X-----------------------EX----X-----------X---------------------------------E---o---------------------------o-------?--------o---|-T-----B-----o-M---B-o--B-------E
--------------X---------o--------------B-o----B----------B-----------E-------o---T----------o----------------------------------o-----o------------X-M----------T------|?|-o--B---o---o-?---------------M
m-----------------------------B---------------B------------o--o----------M---B---|---o----------------------X-B--------------o-------------------------------o-|---X--|-|o---------------B---------X----
XXXXX-XXXX-XXXXXXXXXXXXXXXXXXXXXXXXXXXX-XXXXXXXXXXXXXXXXXXXXXXXXXXXXXXXXXXXXXXXXX|XXXXXXXXXXXXXXXXXXXXXXXXXXXXXXXXX-XXXXXXXXXXXXXXXXXXXXXXXXXXXXXXXXXXXXXXXXXXX|XXXXXX|X|XXXXXXXXXXXXXXXXXXXXXXXXXXXXXXX
