--------oM--------M---T-----X--o-X--MB------------------------B--------M------oB--------------------E--X--------------?--------------B-----M--X----B-E-------B-------B-----------B---------B-------E----
-B---B--?-------------|------?T-----o-XX---B------------------------B-E--B----M-X-----------------B-------------E---B----------X-----X----------X----------------------o---------------o--B------o-----E
---o-------E-----|--o---------|o-----------------E----E-------------E--?-------E----?---------------------------------------?-?-----------B---o?----B--------o---------------BB-------------E-----------
----------------?---X-|o---|------B----B------|---M----------------------M---X------------B------------B------EX-------X---B-------B----------------------------X------------------?--?-----------?-B---
----------E-----------|----|oE-B----M---------|----BX--B---E---B--------M-------T-----BB-----B-X---B--------?--o----B------------o--E---E--B-?-?-------|---B--E------?------X---Bo--B---X-X--T--XX------
-------X--Bo----------|M---|---------BB-----B-|--------------B-B--B-------------|T--------X---B------M------------X-----------T--X--T--------B---------|------------E-----o--??------------------TX-----
--E--------------|----------E-|B-----------|---------|-------B----T------o--------?-----------------X---|---M----M--------------X--------------------------E?-------------B----------------MX----X------
X-----------------o---|B|--|------------------|--------------------o?-------?--E||---------M--M-?---------------------o---M---|B----|--B|-----E-------------?--X--T--o-------------------------?---B-o-v
---------X?-----Bo-E----------|---|-E------|-B-------|-o?-------M-|o----?--B------E---------------------|X--?-B--------------|-----B-----------E--------------X-?-|-----B-BB-------?----------------T---
T--X------T-B---------|-|--|B-----------------|-----------------------------B-|-||-E-------|-----?---B--------------E---------|-o--E|---|-----------------o-------|--T----B-BB---------B-B-------o--|---
----------|-----------|o|-B|-------?----------|o-E-------T----------M---------|-||--------o|-------------E-----?----o---XB----|-----|X--|--?----------||-------M-----B----------|---------------E---|---
----X-T---|XB---------|-|--|--o-----X---------|B--o------|-------X------------|-||--------------------B-|----M---------------|---------------------?----?---E-----|--|X------o---------------o----E-|---
-B--B-|---|--------B--|-|--|--T---|--?--o--|----X----|----------|E|--?|----------o--B-------M---BXE-----|--oo----------------|--------------------X------E----E---|-X|---M----E--o-E?o--------------|---
---B--|---|-----X-----|-|--|--|---------------|--------T-|----B-------------B-|-||------BB-|--|-------------E--?-----T------M|--------B--------------------------X|--|-EE--------B------------------|---
m-----|---|----------X|-|--|--|B--X--B--E-----|------?-|-|--------------?-----|-||----M----|--|---------E----E-B------|-------|--o--|---|----E--------||-----------------------E--EE---------BX-----|---
XXXXXX|XXX|XXXXXXXXXXX|X|XX|XX|XXXXXXXXXXXXXXX|XXXXXXXX|X|XXXXXXXXXXXXXXXXXXXX|X||XXXXXXXXX|XX|XXXXXXXXXXXXXXXXXXXXXXX|XXXXXXX|XXXXX|XXX|XXXXXXXXXXXXX||XXXXXXXXXX|XX|XXXXXXXXXXXX-XXXXXXXXXXXXXXXXX|XXX
