M-----B---o-------M---T-----X--o-X---B-----------------------------B?-------------B------o--o?---M-----------------B?-EM-----?----------------------o--TB--------------M-------B-B---------B-------E----
----------------------|----T---------------X--TBX------------B-------------B?------------------MB------------------------------BB---------------X----------------------o---------------o--B------o------
---o---------?-----E----------B--------X-------------BBB-----|-----------------E----?---------------------------------------?-?-----------B---o?----B--------o---------------BB-------------E-----------
----------------?---X-|o---|------B----B------|---M----------------------M---X------------B------------B------EX-------X---B--B---X---------XEo---E-------------X------------------?--?-----------?-X---
o----M-?-B---------o------BT------X----?-?----|----BX--B---E---B--------M-------T-----BB-----B-X------------?-------B------------o--E---E--B-?-?------o|---B--E------?------X---Bo--B----B------------o-
--------------B-----------?|--B------------o-?--E-X--?----|--|----?-------B--E-----------o-----------M------------X-----------T--X--T--------B---------|------------------o--??-------------------X-----
----BB---o--X--?-----------|---X-----X---?----|---X-----o-----M--?----X-B-------|-?-----------------X---|---M----M-----------o--X--------------------------E?-------------B----------------MX----X------
------?---B-X---o----------|---B?------XX-----E--------------------o?-------?--E||---------M--M-?---------------------o---M---|B----|--B|-----E-------------?--X--T--o--T----------------------?---B-o-v
-------------------E--|-|--|--X---E--------X--|-E---------------M-|o----?--B------E---------------------|X--?-B--------------|-----B-----------E--------------X-?-|-----B-BB-------?----------------T---
-------M---------B-B-------|--T--------------X--|---?o----|-?|--------------|---||-E-------|---------B--------------E---------|-o--E|---|-------------||---------o--------------|-B---B--B-------o--|---
------------B-E---E-----B--|--|-----o--?------To-E-------T----------M---------|-||--------o|-------------E-----?----o---XB----|------------B----------------------|--|-----------E--------------E---|---
-----TB----M---------------|--|---B------------B|----B----|--|------T-------|------------o------------?-?----|------oE------M-|-?---|--M|-------------||---------?-----------o---------------o----E-|--B
-----|----?------o-o--|-|--|--T---E----------E|----------------------------?--|-||B--------|-B|-M-----B---------------T------|--------------------X------E----E---|-X|---M----E--o-E-o--------------|---
----E|----?B------------X--|--|-----|E------T-|-|------B-B|?-|--B-B-|-------|---B----T---X---B----E---o------|T---------B---?-|----------Bo--|-------------------X|--|-EE--------B------------------|---
mE--o|B-------------B------|--|---X--B--E-----|------?-|-|-----------------------------B-----E-----T---o|-B----------|-------|-------Eo------XE---o---M--?-E------|--|---------E-------------BX-----|---
XXXXX|XXX-XXXXXXXXXXXXXXXXX|XX|XXXXXXXXXXXXXXX|XX?XXXXX|X|XXXXXXXXX-XX|XXXXXXXXXXXXXXXXXXXXXXXXXXXX|XXXX|XXXXXXXXXXXX|XXXXXXX|XXXXXXXXXXXXXXXXXXXXXXXXXXXXXXXXXXXX|XX|XXXXXXXXXXXXXXXXXXXXXXXXXXXXXX|XXX
