--E------------B-----------M------------M-----B------o----------------B-o---?---------------o---o-----o-------?--B-----------------------------------o----------M-------B----------B-----?----B----?----
------------B-------------------------?-------?o-------------------------B--o--E--X-o----o---?--MM--?--?------M-----B---------E--------X-MBM-----B-------------?-----B--------------E-----------?-------
B-B-----B--------------o--------o-------M---B-o-------o--M----------------B--------oo----------------Bo------------------------------------------B------------------B-B--B--B-----E-------------?----o--
-X--------?------------o----------o---B---------M---BB----M-----B----------------------EB--B-------------B------------?----o---o------B-------B----?--------?---o----------------o---M------X----M--B---
----------BB--------?----------------------X---o---B-------------?-------------o-------------------------o----------------------------------------------------------M---------M-----M--E---------B------
--B-B------?------------B----------B--------------Eo--------------o----o?--o------oB------------?--------------o------o-------?-------B----o---------------Bo--------M--M--------BM-------------o-B---?-
---B--?-X-------------------------B-------B---------o-------M---?-----------------------B------o-----------M---------------B------?----------------------o-----?-----?---------B--------------------o---
-?----------M-------------------B--------------B------------------o---------------B--o----o---------------------------------------?----------o------o--------B-----------------------------M---------B-v
----o-B---------o--o------------------X------------o-------------oo-----------------------B---B--------o-M---------B----------------B-B------?------o--------B---------------o-------?-----B------------
-------o-B--E---B--------------------------?--------X--------------------B------X----------------------M------M------M----------------------?o--------------oX-----?---------Bo-------------------------
---------------B------?---o-----------o--------?---------------------BT-MT-----------------X?-----T---------?---X------------B-----?--------o-----E---E------o-------------B---o---------o--------------
-M---------------E--------------M----B-o----------------------Bo---------BB--------------B-B-BM---|------M----------------------o-------?---------X-o--------------------o-----o-----M-B----?-----------
-----------B---------B---B-----o--------?o-------------E--------------|--|------------------------|-----------?-------B----o-------------------X---M--------?--B----?-------o-----------Mo---------o----
-o----B--------------------?o-BB-BB------o------E-----o---------------o----o------o-----------|-M-o-----o---XM-B---------M--o------------------------Xo------------------------M-E---------o--------B---
m-T------T-----M--B------E-------B----o-B-E------o-----------X--------------------M---B-M-M---|---------B---E-----------B--------X-------?--------------------------------------B------?---?--B-M-------
XX|XXXXXX|XXX?BXXXXXX?XXXXXXXXXXXXXXXXXXXXXXXBXXXXXXXXXXXXXXXXXXXXXXX-XXXXXXXX|XX|XXMXXXXXXXXXXXXXBXXXXXXXXXXXXXMXXXXXXXXXXXXXXXXXXXXXXXBXXXXXXXX-XXXXXXXXXXXXXXXMXXX?XXX?XXXX-XXXXXXXX-XXXXXMXXMXXXXXXX
