----------------------E-?-----X---oE---------------------------?--------------o--E----------Mo-----------o---------------------o-------------------B-----B--------------------o-------------------------
-------------------------------------------B-----------E------o-B----------------o----------------X-------------B-?------------EE--------------------?---------E-B----------------E----B?---------?o----
o-B--------M-----------------------?-----------------------------X----X--o-----------------?--o-----B------B--------------------------X----------o------?--------------------B----?---B?------------?---
---------E----B--M------------o-----B-o------------B----B-----------------------------------------E-------------------------------Bo----------o---o--------------------o---o------------------B----o----
-------oXBMo--Bo---------B--B---------B----------------o-----------------------?-o-------------------------o--B-------B-----------B-----BB---------------B------------o--------o----M--o----------------
M-----------B-o----?-?-o-------------E----------o-----------o------------------?------B---------------------B-------------o-------------------Bo-----------------o--o-----E----o----------------------?-
B-----o---o------------o-----------------B-------------?---------------X-------------------o--------------------B---------?-------------?----X----Bo--------B-----------------------B------?------------
----------o--------------o-X----B---------B-----o-------------------o-----------------------------o----------------oo-?---------------------------B---E----------------B--------------------B----------v
-B---?---------------o-----------BB-------?-----------------B-------------------E------B---------------------------o----M-----M----------------------X---------------------------------B-------o--------
----------------------------------E-------------B----oo---------B--?-------M-----B----------------------o---------------B--E------B---B---------B-B?----------------------B-B----M--o-------------------
---------------o-o-B----------------------------o--------------------------------------o------B-o---------------------B----------B--o-----o------------------o--------------------------T--------M-B----
----o-----|--?----------------------------o--o---o------------------B-----o-------------B-------------------------------------M------------------------o----M-------------o---o---B---B-|-?--------B----
Eo---B-----o-------------o----o--X--------------------oo--o----E-----------o-------------------------E---B-----------------o---------------E-----------------------B---------B----------|------o--------
---------------------------o------------------------------B-------------------------------------------------o-------------B---------------B--------------X----oo----o-------------------|-----?--TX-----
mo-----------------X------------B------o-----o-------o--o------------------------------------------------------o--o--X-----o------|------M-----------|-------------------------B-------o--|------|------
XXXXXXXXXXXXXXXXXXXXXXXXXXXXXXXX-XXXXXXBXXX?XXXX-XXXX-XXX-XXXXXX-XX-XXXXXXXXXXXXXXXMXXXXXX-XXXXXXXXXXX?XXX-XXX-XXXXXXXX-XXXXXXXXXX|XXXXXXXXXXXXXXXXXX|XXXXXXXXXXXXXXXXXXXXXXXXXXXXXXXXXX-X-XXXX?XBXXXXXX
