o--------------------------------B-oo-----o--------o------------------M--------------------------------oo------o--?--------------o-----X-----------B--------B-------X---------o--------o-------o--------
-X------o--------B-B-M-oo---o---o-----oE-----------------o------------------M----------------o-B------X------------o----------o---E--------------B---Bo-------------?--B-----------o----M----B----------
----------Bo------------------------o---M---Eo----------------?----------o--------------EB---X?-o--------------------------------------------------o---------B----------------------B------o------------
----------------------B-----X--X-----------o--------o---------E--------o-----------------------B---EE------o----X-----E-----M-----M?-o---------------M-------E--o---------------------?---E-------M-----
---------o--B------?-------------------------?-----------------------E-----------------------------------E--------B-------------------------------X---o--------------BX---------o--oo----------B--------
--------B---?----B----------o--o------------------------oo----o------------------B---------------------------------------o-----X------o----------o---o--B---B-o------------------------E----------------
--B---------------------------B----o---------------------------B---X----------B------------------------------------?-------B---------------------------------------------------o---B---------B---------B
--B------------------------B----------------X-----o-----X?---------------------------------o---o-B-----------------MX------------o----------o----o-----o-M-B------E----oE------------------------------v
------o-E-----------------------o---------------------------------------------------X--o----------------------------------?X------------B-B-----M-----X--------X---o----------M---B--?----------?-------
------o--?-B-B-----E-----E---------------o--------o--oo-MB-------------------------------------o-----------E----------M-------------X-B--o---------------------B------------------------------------E-?-
-----------EB-------------------------o------E------o-o--M-------------oo---o---B-------o---B-----------M---------------------o--o---oM---B----B-------o---------X-----------------------------T--o-----
-----M-B---------------------------B-------o-?-------------------------------X--o-oE------------Bo----------?-----------E-o---------------------------------------B------M?o----B--------o-----|--------
-------B-------o----------------B-------------------------------B------o-----------?--------------------------o--------Bo--M------B-----XXo----B-----------------E------o----o-----------------|--------
---------------?--o-----------------o-------------------M------E----------------------------?|--o------------------o--------X--X------------B------o--B---------B----------M---E---------------|---Bo---
m---------T--------------------------------------------o----------------------------------o--|-------------o-X-----------X------?---------o-------?--o----M------E-o----M----------------------|-?--M---
XXBXXXXXXXXXXXXX-XXXXXXXXXXXXXXXXXXXXXXXXXXXXXXXXXXXXXXXXXXXXX-XXXXXXXXX|XXXXXBXXXXXXXXXXXXXXXXXXXXXXXXXXXXXXXXXXXXXXXXXXXXXXX-XX-XXXXXX-XXXXXX|XXXXXX|XXXXXXXXXXXXXXXXBXXXBXXX-XXXXXXXXXXXXXXX-XXXXXXXX
