-------------------------------------------------------------------------------------------------------------------------------------------------------------------XXXXXX-------------------------------
--------------------------------------------------------------------------------------------------------------------------------------------------------------------------------------------------------
--------------------------------------------------------------------------------------------------------------------------------------------------------------------------------------------------------
--------------------------------????????----------------------------------------------------------------------------------------------------------------------------------------------------------------
-----o------------------------o----------------------------------------------------------------------------------------------------------------------o--B-----------------------------------------------
---------------?---------------------------------------------------------------------------------------------------------------------------------------------------------------------B------------------
---------------------------------------------------------------------------o-----------------------------------------------------------------------------------------------------X----------------------
--------------------------------------------------------------------------------------------------------------------------------------------------------------------------------XX---------------------v
---------------------------------------------------------------------------------------------------------------------------------------------------X---------------------------XXX---------------------f
--------------------------------------------------------------------------------------------------------------------------------------------------XX--------------------------XXXX---------------------f
-------------------------------------------------------------------------------------------------------------------------------------------------XXX-------------------------XXXXX---------------------f
-----------------------------T---------------X--------------------------------------------------------------------------------------------------XXXX------------------------XXXXXX---------------------f
-----------------------------|---------------------------------------------------------------------------------------------------------------T-XXXXX-------o---------------XXXXXXX--------o------------f
-----------------------------|---------T-----------------------------------------------------------------------------------------------------|XXXXXX----------------------XXXXXXXX---------------------f
m----------------------------|---------|--------E---------------------------------------E-----------------B----------------------------------|XXXXXXE---------------M---EXXXXXXXXX---X-----------------X
XXXXXXXX--XXXXXXXXXXXXXXXXXXX|XXXXXXXXX|XXXXXXXXXXXXXXXXXXXXXXXXXXXXXXXXXXXXXXXXXXXXXXXXXXXXXXXXXXXXXXXXXXXXXXXXXXXXXXXXXXXXXXXXXXXXXXXXXXXXX|XXXXXXXX-XXXXXXXXXXXXXXXXXXXXXXXXXXXXXXXXXXXXX-XXXXXXXXXXX
