--------------------------------------------------------------------------------------------------------------------------------------------------------------------------------------------------------
--------------------------------------------------------------------------------------------------------------------------------------------------------------------------------------------------------
--------------------------------------------------------------------------------------------------------------------------------------------------------------------------------------------------------
--------------------------------------------------------------------------------------------------------------------------------------------------------------------------------------------------------
--------------------------------------------------------------------------------------------------------------------------------------------------------------------------------------------------------
-------------------------------o------------------------------------------------------------------------------------------------------------------------------------------------------------------------
------o-------------------------------------------------------------------------------------------------------------------------------------------------------------------------------------------------
---------------------------------------------------------------------------------------------------X----------------------------------------------------------X----------------------------------------v
------------------X--------------X----------------------------------------------------------------XX---------------------------------------------------------------------------------------------------f
-----------------XX-------------XX---------------------------------------------------------------XXX---------------------------------------------------------------------------------------------------f
---XXXX---------XXX------------XXX--------------------------------------------------------------XXXX-----------------------------------------------------------------------------------------------B---f
---------------XXXX-----------XXXX-------------------------------------------------------------XXXXX---------------------------------------------------------------------------------------------------f
-------X------XXXXX----BBBBB-XXXXX------------------------o-----------------------------------XXXXXX---------------------------------------------------------------------------------------------------f
-------XX----XXXXXX---------XXXXXX-----------------------------------------------------------XXXXXXX---------------------------------------------------------------------------------------------------f
m------XXX--XXXXXXXE-------XXXXXXX----------------------------------------------------------XXXXXXXX---------------------------------------------------------------------o-----------------------------X
XXXXXXXXXXXXXXXXXXXXXXXXXXXXXXXXXXXXXXXXXXXXXXoXXXXXXXXXXXXXXXXXXXXXXXXXXXXXXX???-XXXXXXXXXXXXXXXXXXXXXXXXXXXXXXXXXXXXXXXXXXXXXXXXXXXXXXXXXXXXXXXXXXXXXXXXXXXXXXXXXXXXXXXXXXXXXXXXXXXXXXXXXXXXXXXXXXXXXX
