oB--------------------o--------E-----------------------------------------o---------------o---?------------------------B--------X--------M-------------------o--------B--o-------------------------------
-B----o-----------E-o--------------o------M----------------B---------B------T----------------E-----o-------------o---B-?---Bo-----------------------o-B-----------?---------oo-----------------------o--
-oo----E---o---------B-----o---------------o----?-----------------o--B-----------------------o-----X------B------------oB--------------?-EX--------o------X--o--o--M-----------B------------------------
o----------M-E--?o---o-------------o----B----------E-------------E------E-----------------------o--oB------------B--o-Bo------------------T---------oE-------E-oo---------------------------------------
---o----------M-----o-------o-Mo------B--------------B-------------?---------o----------B---------------------o-o-----X-----------------o------------------------Bo-o-o---------------------------------
-----------------o-----BX--------------?-------o---------------------------o--?-------------------o---------oo-------o--o---------?---B-o-----o-----------Xo--------oE-B---------o---------X------------
--------M---------?-o-------------------------o-----B----B-o------------B---o-------E---------B---------B-------B-----------o---o-o-------------------o---------------------------------------------o--T
----T---------o-o-----o--------o-----o----B---M-----------o--------o----------?--o-----M---------------------o---B---------------------------------o-------o----------------o------BB-B---------------Mv
---------------M------B?--------o----------------X-------X---X-----------------------o------------------------o--o---------o--------------B-------Mo----X----Bo----------------------------o-----------o
--------------------o--B-oBB------------o----------------------B--------o---------------------------------o------------------------------?------B--EB-ooEB---B?---o----X--------B?-----------------B----
---------------o---o-X------------B--Bo--------------------------o------------E---B---------------o----o---------o--------------------B----o----------X-----B--B---o--------TB------o-------------------
--------BX------E-------X----------o------o-B-o----o-------T-------E----------X--------o---B-o-?---o--o------o-----?--o---X-------?----------------------o-------o-o--------|oo-----B-------B-----------
--------B--------?----B-------o-o-------------o-X---------?|-------------?---B-------------------------------------------B-------------------B---------------?-o---T--------|-Bo------------------------
-------E---------------------o-----o----o----------E---|----o-------------------------X---------o----o--B----?--------E--------Bo--------------B---------M---------|--------|-B----M-------B------M-----
m--B-------------X---------oM------------E--o--o-|--o-X----|---------------X----------------o---o-----B--E---o------------------------------------------o----------|--------|--------B------------o-----
XXXXXXXX-XXX-XXXXXXXXX-XXXX-XXX-XXXXXXXXXXXXX-XXX|XXXXXXXXX|XX-XXXXXXXXXXXXXXXXX-X-XXXXXXXX-XXXXX-XXXXX-XXX-XXXXXXXXXXXXXXXXXXXXXXXXXXXXXXXX-XXXXXX-XXXXXX-X-XXX|X-XXXXXXXX-XXXXXXXXX-XXXXXXXXXXXXXXXXXX
