--------------------------------------------------------------------------------------------------------------------------------------------------------------------------------------------------------
--------------------------o-----------------------------------------------------------------------------------------------------------------------------------------------------------------------------
------------------------------------------------------B-------------------------------------------------------o----------------------------o------------------------------------------------------------
-------------------------------------------------------------------------------------------------------------------------------------------------------------o------------------------------------------
--------------------------------------------------------------------------------------------------------------------------------------------------------------------------------------------------------
---------------------M------------------------o---------------------------------------------------------------------------------------------------------------------------------------------------------
--------------------------------------------------------------------------------------------------------------------------------------------------------------------------------------------------------
-------------------------------------------------------------------------------------------------------------------------------------------------------------------------------------------------------v
-------------------------------------------------------------------------------------------------------------------------------------------------------------------------------------------------------f
---------------------------?-----------?---------------------------------------------------------------------------------------------------------------------------------------------------------------f
----------------o--------------------------------------------------------------------------------------------------------------------------------------------------------------------------------------f
--------------------------------------------------------------------------------------------------------------------------------BBB--------------------------------------------------------------------f
-------------------------------------------------------------------------------------------------------------------------------------------------------------------------------------------------------f
----------------------------o--------------------------------------------------------------------------------------------------------------------------------------------------------------------------f
m-------------------------------------------------------------------------------------------------------------------E----------------------------------------------------------------M-----------------X
XXXXX-----XXXXXXXXXXXXXXXXXXXXXXXXXX--XXXXXXXXXXXXXXXXXXXXXXXXXXXXXXXXXXXXXXXXXXXXXXXXXXXXXXXXXXXXXXXXXXXXXXXXXXXXXXXXXXXXXXXXXXXXXXXXXXXXXXXXXXXXXXXXXXXXXXXXXXXXXXXXXXXXXXXXXXXXXXXXXXXXXXXXXXXXXXXXXX
