---o---o-------?---------o---------------B---?---------------B---------------B--------------------?------------------------------------------------------------------------B-------------BB--------o----
------------------------------?-o--------------------------------o-------------------------X---B-o-------------------o-------------o----BB----------------------------X-----B----------------o---------X
---------------o------o---------o----------X----------------B------oo----B--o------------M----------E------------------------------------M-----o-------------------------B--------------------B---------
-----B------------------------------X--?----o-------oX--------------B---M-----------------------------o------------------------------------------o?--o------------B-------------------------o---------o-
---------------?-B-----------o------------B-------------------------------B-----o-----------o--M----------------------o--------------------------------o-----------------------------------------------?
--------------B---o---X---X---o-----------------------------o----------------------------------------------------------B---------------o--------------X---------------?--B-----------E------------------
---------------------------------X-?-----------oo--o------o---------X--------MX--------?----------o--E--------------------o-o-----------------------B------------------------o------------------X-----B-
-X-----------o----------o-------------------------------------------o----------------M-----------B--E------B-----------M--------------X?--------B-o-?-------------------o-----B-----------X----o-------v
------------------o?--------------------------------------------------------o-----------------------------------o---------o---------------------B---?-----------o-------------------oX------------------
--------------------o-------------------------------------------------oX----o---------o--o-------X-B---o-o-----------B-------------B-ooE-----------------------------------B----------------B-----------
-B------o--------Bo-------------------M------------------------o---------------B-------oo-----oX------------o-------------------------------------------------------------------------------o-----------
-o----E---X--------o-------------------------------B----T-----o------B---E-------B------------o----------------------X-------------E--?---------B------o------------------E-----B-------?-----o---------
--------------B--------B---------------------------------------------------------------------------------------------------------------E-B--B---o-o--E---X------o-----o---------T--o-------M-B-----B-B--
---------B-----B--------------------------------------------------------o-X----o-------------------------------------------------------T------o--------------T-----E------------------------------------
m-o-----------------------------B---------------------Bo--------o-------------------o---------o----o-|------------?-o--------------o---------------------|o--?---------o---------Bo--------B----------E-
XXXXXX-XXXXXXXXXXX-X-X-XXXXXXXXXXXXXXXXXXXXXXXXXXXXXXXXX-XXXXXXXX-XXXXXXXXXXXXXX-X-XXXXXXXXXXXXXXXXXX|XXXXX-XXXXXXXXXXXXX-XX-XXX-XXXXXX-X-XXXXXXXXXXXXXXX|X-XX-XXXXX-XXXXXXXXXXXXXXXXXXX-XXXXXXXXXX-XXXX
