--------------------------------------------------------------------------------------------------------------------------------------------------------------------------------------------------------
--------------------------o-----------------------------------------------------------------------------------------------------------------------------------------------------------------------------
------------------------------------------------------B-------------------------------------------------------o-----------------------------------------------------------------------------------------
--------------------------------------------------------------------------------------------------------------------------------------------------------------------------------------------------------
-------------------------------------------------------------X------------???-------------------XXXXX---------------------------------------------------------------------------------------------------
---------------------M--------------------------------------XX--------------------------------------------------------------------------------------------------------------X---------------------------
-----------------------------------------------------------XXX---------------------X---------------------------------------------------------------------------------------XX---------------------------
---------------------------------------------X------------XXXX--BBBBBBBB------XT--XX-----------------------------M--------------------------------------------------------XXX--------------------------v
-??------o-----------------------------------------------XXXXX---------------XX|-XXX-----------------------------------------------------------------------??????--------XXXX--------------------------f
---------------------------?-----------?----------------XXXXXX--------------XXX|XXXX------------------------------------------------------------------------------------XXXXX--------------------------f
----------------o--------------------------------------XXXXXXX-------------XXXX|TXXX-----------------------------------------------------------------------------------XXXXXX--------------------------f
------------------------------------------------------XXXXXXXX------------XXXXX||XXX-------------------------------------BBB------------------------------------------XXXXXXX--------------------------f
-----------------------------------------------------XXXXXXXXX-----------XXXXXX||XXX---------------------------------------------------------------------------------XXXXTXXX--------------------------f
----------------------------o-----------------------XXXXXXXXXX----------XXXXXXX||XXX-------------M------------------------------------------------------------------XXXXX|XXX--------------------------f
m------------E--E---E-------E----------------------XXXXXXXXXXX---------XXXXXXXX||XXX-----------------------------------------E-------------------------------------XXXXXX|XXX--------------------E-----X
XXXXX-----XXXXXXXXXXXXXXXXXXXXX-------XXXXX-XXXXXXXXXXXXXXXXXXXXXXXXXXXXXXXXXXX||XXXXXXXXXXXXXXX------XXXXXXXXXXXXXXXXXXXXXXXXoXXXXXXXXXXXXXXXXXXXXXXXXXXXXXXXXXXXXXXXXXX|XXXXXXXXXXXXXXXXXXXXXXXXXXXXXX
