---o-M------------------------------X-------------------------------------B------B----o-------------------------------------------------------------------B---------------------------------------------
---------------B---------o--------o----Bo-----------------o-X-----?-----o----------o--B------------o---------------o-----B-o----------------o--------------------?---------o----------------------------
----------------------------X--o---------------------------------------------o--------------E----------------E-----------------------------------------------?----------B----------?---------o----------
------------------B---o-------------------o----M-?--------------------?------------------------Bo-------------------------------o-B-----------------------M-E?-----M----o----------------------------?--
-----------------------------------X------------o------------B----------------------------X-----------o----------oX-oX----------------o----B---------o--------------B-B--Moo--------E----o-E------------
--B-----o-----------------------------------o----------Xo--o-----------X--------------------EB-----------------o---B----------------X----------o-B-----o-----o---X---------------------X--------M-------
-------------?------o-?B-MB---------------o----------o------B-X-------------o-----------Moo----------B--------------o-------Mo--------------?-----------------------------------------------?-----------
---------------------o--?---------------------------------?---------------X----E---B-------E-----o--E--------------------B---------------B-----------------------------------------------------o---oB--v
---B-------o----o-----o--X--------------------------------o------------------------------E-------E-o-----------------------o-B-----o-----------------------o----B-------B--------X--------------------oo
---?--------------------?---M---------------------------?------------------B-------o---o-----------------o------------B-------------o----------------?------o------------B--------------?---------------
--------------B?--------------------o---T----------B------------------------B-------------------------------o--------------?---oE-----o----------------E-----------------o----------T-------------------
-B---------o--------------B-------X-----|----------oX----------------T------------------------T--------B--------B-o-------------------------------------------------------o---------|------o------------
----------------o-------------------------T------------------|-X--------------o-------B------o-o------------M-o-o---------o----------------B-----------------------------------------------------------o
--E----X--?B--------?---------------------|---o------B-------|----------------MB-------o----------o-----|-------|--o-----------------------B----------o-----------------------o-----|-o--?o-------------
m---------------------?---?---------------o----------------------------T---------------------o--o---?---|B------|-------?---o---------E---------------------------------------------|----B---?---Bo-----
XXXX-XXXXXXXXXXXXXXXXXXXXXXXXXXXXXXXXXXXX-|XXXXXXXXXXXXXXX-XX|XXXXXXXXXXX-XXXXXXXXXXXXXXXXXXXXXXXXXXXXXXX|-XXX-XX-XXXXX|X-XX--XXXX-XXXXXXXXXXXXXX-XXX|XXXXXXXXXXXXXXXX-XXXXXXXX-XXXXXXXX-XXXXX|XXXXXXXXX
