---B-B-----o---o-----?-----------o-----------E-------------?-----o----B-----------------?-------------------------?---------------M--------------------?-----------------?--?-----------oo---o----------
----------------o------X----------E---------------------X---------o---------o--------B-------B----------?----------------------B-----B---?--?---oE-----M---------------------o---------?---------o------
----------------M----B-----------E-o------------o--?-----o--B-o--------------oB------------------------o-----------------------------------------B-------o--------------?---------B----X----------------
---------B-B-o------------X---------o----B-M-----------E-----o--o-------B---------------------------------------------------------------M-----------------o---------------------B----B--------E-B------o
-------B-----X-----BM---------------X-o----o?---E-------------------B----M--o--------------------------------------------?------E-----o---Eo-------X----------------------?-----------------------------
---------------------B-------------o--X----------o---------B-------o------o------------------------Bo---B-------------------B----------B---------X------------------E---------M-------------Bo------B---
-o-M-------B---------------------B---------------X-------oM------B----?--X---------B--B--------------------------------o---M-----------o------------------------o------------------------B--------------
oB--o----------B--------M---o--------?-------?-----Bo--------?-----------------B--------B-----B-?-----o--------------------------------------------------------?-B-B----B-----?-B--o-----------------oov
------------------o-X----------------------------------B---oB--------------------------?------B----------------------M------------?-E-------------------?--o-------?---o---E-----X--BB--E--X-------?----
----------------------M----X----------------B---------------B----------Xo--B---------o--------------E--------------------BoE---------B-----------?-------o----X--------o--------?-----------o-o---------
---o------?B----o------------------------------------------------------------B--?-------------------------o-------B---o--------o--o---------------M---------?-------------------------------B-----------
--------?-----------E----------------BB---------------B----------------B-------o-B-------------oBo----------------------------o-------T---M-------o-o-------B-X-------E-------X--------o---------X---B-?
------------o-----M-----M--------o------------E---------------------B-----------B-E--------Bo----------------?-------------------B---------------X---B----------------o-----------------o-----B-----B--E
----o------B---B?o------------B-------------------------------------B--?---------------------------o-------B-B------------M-------?----------------?----o---oo--------------B---------------------------
m--o-o-----B---o---------M---------o-----?----B------------o------B----------------X-----?----------------o---o?B-------------B------?-----X-----------------------------M---------?--------------T-----
XXXXXXXXXXXXX-XX-XXXXXXXXXXXXXXXXXXXXXX-XXXXXXXXXXXXXXXXXXXXXXXXXXXXXXMXXXXXXXXXXXX-XXXXXXXXXXXXXXXXXXXXXXXXXXXXXXXXXXXXXXXXXXXXXXXXXX|XX-XXXXBXXXXXXXXXXXXXXXXMXXXXXXXXX?XXXXXXXXXXXXXXXXXXXXXXXXXXXXXX
