-------o--------------o---------------------------------o---o---------------B--B----o-?------o-------B-----B------------o-------------o-------------X----o-Eo--B--o----B--o----------------X------------
-o--B------o--M-o--------Bo?--------------o--------o-o-----------------------------E?-----------------B-o------------B---E-----------------o-----------?B---?----B---------------o----------------------
-----------------------------?---o---------------------B---B------------o-------B--?------------------B---------------o-------o---------------o----o----o----------------------------------------o------
------o------B----EM---------------------E--------B-o-----------?----B----B----M--Mo-o--------X----------E--B-----oB-----o---------------?-------M--o-o--------B-o----------B----------------E---o-----o
-------------B-------X------------B-------------oX-X--B-----------------o-------B------o--------------o----------?---o----------------------------------oBB---------o--------E---o----E---E------------T
----B------------------------o--------------------------------------------------------o-?-------X---o---B--B----E---o--------Mo---------------B-------B--o---------------------------------------B---X--
---o----------------------------------?---o-----------B-----------------o----B---B-----------------o-----------------------o------B------o----------------o-M---------------------B---------------------
------o---------?--X-------?-o-----o--------------------------E------------o----o-----------------------B-----X-X------------------------------?---------o-B-------o-E--------E--------B----B-M-----o--v
---oE------X--------------------------E-------M------------------------o-X---------------o---o--?----B---------B-o-----?--XE--o---o--------------B------------------------B-----------------------------
--------------------------------o-----------------------?-X--o------------X--X----o-------------?-------------------------------B---B--B-------------------------------B----o-----------------------o-XB
------------------------------?--------------------o-E-----o-o-----X---------B------oB---------------B-E------o------M----------------------------X------o----B------------B---------B------------------
----------------M------X----B-----o-------o----------o---------?---o-------------------o-o-oo----E-oo------------M--o------o---------M-------------------B---------------B------o--------B-----To-------
--------------------o-------T------------o-----?--o---------------------To-------------------------B-------------?-o--B-----------------------o-------o---------------------o---------X--------|--------
--------------o----B-----B--|--------------------T-M-----B--------B-B-o-|----------------M----------------o----o---X---------X--B----------o---o---------------------------------------?-o---o-|---o----
m---------?--------------oo?|-------T---------B--|-oB-T-----------------|-------B------B----------------------------------------?---Xo------------------------------E----B-------------------o-|--------
XXXXXXXXXXXXXXXXXXXXXXXXXXXX|XXXXXXX|XXXXXXXXXXXX|XX-X|XXXXXXXXXXXXXXXXX|XXXXXXXXXXXXXXXXXXXX-XXXXXXXXX-XXXXXXXXXX-XXXXXXX-XXXXX-XXXXXXX-XXXXXXXXXXXXXXXXXXXXXXXXXXXXX--XXX-XXXXX-XXXXXXXXXXXXX|XXXXX-XX
