--------------------------------------------------------------------------------------------------------------------------------------------------------------------------------------------------------
---------------------------------------------------------------------------------o--------------------o-------------------------------------------------------------------------------------------------
-----------------------------------------------------------------------------------------------------------------------------------------------------?--------------------------------------------------
--------------------------------------------------------------------------------------------------------------------------------------------------------------------------------------------------------
--------------------------------------------------------------------------------------------------------------------------------------------------------X-----------------------------------------------
---------------------------------------------------------------------------------------------------------------------------------------------------------??---------------------------------------------
-------------------------------------------------------------------------------------------------------------------------------------------------------------------------------------?------------------
----------------------------------------------------------------------------------------------------------o-----------------------Xo-------------------------B------------------X-------o--------------v
-------------------------------------------------------------------------------------------o-------------------------------------XX--------------------------------------------T-----------------------f
--------------------------------------------------------------------------------------------------------------o-----------------XXX-------------?------------------------------|-----------------------f
--------------------X----------------------------------------------------------------------------------------------------------XXXX--------------------------------------------|-----------------------f
-------------------XX--------------------------------------------------------------------?------------------------------------XXXXX-----------------------------??----------T--|-----------------------f
------------------XXX--------X-----------------------------------------------------------------------------------------------XXXXXX------------X-----------o-----------o----|--|-----------------------f
-----------------XXXX--------XX---------------------------------------------------------------------------------------------XXXXXXX-----------------------------------------|--|--T--------------------f
m---------------XXXXX--------XXX-----------------------------------------------------------------------------------E-------XXXXXXXX---------M-------------------------------|--|--|--------E-----------X
XX-o--XXXXXXXXXXXXXXXXXXXXXXXXXXXXXXXXXXXXXXXXXXXXXXXXXXXXXXXXXXXXXXXXXXXXX--------XX------XXXXXXXXXXXXXXBXXXXXXXXXXXXXXXXXXXXXXXXXXXXXX-XX-------XXXXXXXXXXXXXXXXXXXXXXXX--|--|--|-----XXXXXXXXXXXXXXXX
