--------------------------------------------------------------------------------------------------------------------------------------------------------------------------------------------------------
-----------------------------------------------------------------------------------------?-------------------------------M------------------------------------------------------------------------------
----------------------------------------------------------------------------------------------------------------------M---------------------------------------------------------------------------------
----------------------------------------X--------------------------------o------------------------------------------------------------?????-------------------------------------------------------------
----------------------------T---------------------------------------------------------------------------------------------------------------------------------------------------------------------------
----------------------------|----------------------------------------------------------------------------------------------------------------------------------BBBBB-------------------------T----------
---------------X----X-------|-----------------------B-------------------------------------------------------------------------B--------------------------------------------------------------|----------
---------o---------XX-----BB|BBBB------------------------------------------------------------------------------------------------------------------------------------------------------------|---------v
------------------XXX---T---|-----------------------------------------------????-------------------------------------------------------------------------------------------------------------|---------f
-----------------XXXX---|---|-----------------------------------------------------------------------------------------------------------------------------------------------------???o????---|---------f
------------o---XXXXX---|---|------------------------------------------------------------------------X--------------------------------?----------------------?-------------------------------|---------f
---------------XXXXXX---|---|--------------M-----------------------------------o-------------------------------------------------------------------------------------------------------------|---------f
--------------XXXXXXX---|---|--------------------------------------------------------------------------------------------?????---------------------------------------------------------------|---------f
-------------XXXXXXXX---|---|----------------------------------T------------------------------------------X-----BBBB---------------------BBBBBBBB---------------------------????-------------|-----T---f
m-----------XXXXXXXXX---|---|--------------------------------E-|-----------------------------------------EXX--------------------------------------------X-----------EE----------------???----|-----|---X
XXXXXXXXXXXXXXXXXXXXXXXX|XXX|XXXXXXXXXXXXXXXXXXXXXXXXXXXXXXXXXX|XXXXXXXXXXXXXXXXXXXXXXXXXXXXXXXX--------XXXXXXXXXXXXXXXXXXXXXXXXXXXXXXXXXXXXXXXXXXXXXXXXXX-XXXXXXXXXXXXXXXXXXXXXXXXXXXXXXXXXX|XXXXX|XXXX
