-------------------------------------------------------------------------------------------------------------------------------------------------------------------XXXXXX-------------------------------
--------------------------------------------------------------------------------------------------------------------------------------------------------------------------------------------------------
----------------------------------------------------------------BBBBBBBB--------------------------------------------------------------------------------------------------------------------------------
--------------------------------????????------------------------------------------------------------------------------------o---------------------------------------------------------------------------
-----o------------------------o-------------------------??????---------------------------------------------------------------------------------------o--B-------------------XX--------------------------
---------------?----------------------------------------------------------------------------M----------------------------------------------------------------------------------------B------------------
---------------------------------------------------------------------------o-----------------------------------------------------------------------------------------------------X----------------------
--------------------------------------------------------------------------------------------------------------------------------------------------------------------------------XX---------------------v
-------------------------------------------------------------------------------------------------------------------------------------------------------------------------------XXX---------------------f
-------------------------------------------X----------------------------------------------------------------------------------------------------------------------------------XXXX---------------------f
-------------------------------------------XX--------------------------------------------------------------------------------------------------------------------------------XXXXX---------------------f
-----------------------------T-------------XXX---------------T-----------T--------------------------------------------------------------------------------------------------XXXXXX---------------------f
-----------------------------|-------------XXXX--------------|-----------|-------------------------------------------------------------------T-----------------------------XXXXXXX--------o------------f
-----------------------------|---------T---XXXXX-------------|-------B---|------------????????-----------------------------------------------|----------------------------XXXXXXXX---------------------f
m----------------------------|---------|---XXXXXX--X---------|-----------|--------------E----------------------------------X------------E----|----------------------M---EXXXXXXXXX---------------------X
XXXXXXXX--XXXXXXXXXXXXXXXXXXX|XXXXXXXXX|XXXXXXXXXXXXXXXXXXXXX|XXXXXXXXXXX|XXXXXXXX--XXXXXXXXXX-----XXXXXXXXXXXXXXXXXXXXXXXXXX-XXXXXXXXXXXXX--|-XXXXXXXXXXXXXXXXXXXXXXXXXXXXXXXXXXXXXXXXXXXXX-XXXXXXXXXXX
