--------------------B----o-B------E-----------------M---------------E---------Xo---?--------------o--------------------o---------------------o------M------o-------o-----------------------------------M
----------E-------?-------o------------------B-B---------E------------------------------o---?------------------------------------o-----------------------------------o--------------------B-B-B---------
---o----B--o----------M------Bo---------------B-----------------M-----------E---------------------o------?B---------o----?--------M----B--------------------------Bo----------o--B----------------------
----BB----B------X---B--------------B--X-----------------------------------------B------------B---B------o-------------o-----------B------o?Mo-B---------------------------------------B---X?-----------
---?-------X-------------?-------------------------M------------------X------?-----E---------oB------------E----------------B----------B---BB-----B-----------o-B--------------------------------X--M---
---?-B------E------B-------------B-o------------M-B-------M-------------------------------------BB-o----------------------------B----B--B-----B---------?----X--------?------------------------E--------
--------X---------------------M------o----------?-------------?----?-E----------------E-----------------o-?----------------------B-----B----B-----oo---------------B------------?-----o------B---------E
--?---------------o----M----Eo---------------------o-------oM---------------------------?---------o-----------------------------X--------------------------------B------------------------------?------v
----B----M---------------------------??---------------------B--------------M----------------o--------------------?----------------o-----------------o----------------o------o-------------B-------------
-B-------------------M------------------?-------------o-------------------------?------o-------------------E-----------B--?-------------o-------------------X----oo----M------------------BE------------
-------------------o--------o-----o------o----B------------o--------------B-------M------------o--------------------o-----o------------o-----X----o---------o-------------X--------------------------o--
---B---------X---------BT--------------------------------M----o-----o----o-----------------------X----------------M-----------------------------------o--------B---------X--B----B----------------------
----M---------------------o--------B--------X----------E-----------B---------------------------------TE-B-----o--------M---------------o----------B----M--B---E-----------------------BM-------oBB------
--------B-------M----------B-------------B--------------?-------B---o------B--------------------T-----------B----o-B------o--o------MB---------------------X?M------------X----------E------------------
m--------E--------------|---------------------o--o----------------------------B---o---o-B-----------o|-----M------?--E---------o--M-----o-------------------o------M---------------------B--------------
XXXXXXXXXXXXXXXXXXXXXXXXXXXXXXXXXXXXXXXXXXXXXXXXXXXXXXX-XXXXXXXX-XXXXX-XXX-XXXXXXXXXXXXXXXXXXXXX|XXX-XXXXXX-XXXXXXXXXXX?XXXXXXXXXXXXXXXXXXXXXXXXXXXXXXXXXXXXXXXXXXMXX-XXXXXXXXXXXXXX|XXXXXXXXXXXXXXX-XXX
