----X----B---------?------X--E--------------X------------------------M--X--------------------------o----oo-----B-------B--------------o--E--X----------------------B--E---o-----------------------o----o
----------------------o---Mo------M---B---------------------M-M---------E------E----------?----o-------------X-------B---------------o-------------B-----------------B---------------B--o---------------
--------?-----E---o-----o------?----------------------B--------------o-------E---------------------B----------B------Bo-----------------------------------------B----------------------------M---X------
----------o-------o-----M--------?-------?-----------B-------------B------B--------E---------------B--------X----------------X---X------B------X----?---------B---B--------B------X--------------o------
-----------B----B-------------------M---------o----B----M--oB--?-------?------E-------------o-----------o------------E?--------o--B----B-B--------B---X---B--B---o-----o--EB-B----E-------------XXB-----
---------B-----o------------o------oM--?--B-----------------------------------o--M-------------o--------------------B-------o-------?-----------------B----------------------------------E-o----------o-
-------------?--M?--------B--o---B----oE--------X------o-------------B-----B-----------o----B-------?-------------B----?------X-----E-------------------------------------------B-----B-----o---?-------
----------o-B----------------B-------------B----B-----B---------------o---------B-B----?-----B-------------------------------------------o-------B---------------E-?--E------B------B------------------v
---?---------M-------------o-------X-----B-----o----o-o-----------------------------E----------?-----------------B---------------------------------M----------------o---------B----------------o---o----
------------------B--o-------?------------B---------------------------------------o-B?--o------M----E--o----B-Mo---------------------------------------o--B---------E------------------oo-o-------------
-------------?-----------?--------------------B-T------------------E--------B----------o-------------------------------------?------oE------o---------o----------------------B?-X---X----o-----------o--
----------------B-----------T-----M----o--------|o--------B--------------o---------------------------------o------------E-o--------------o------------o----------------------o-o------------------------
-----------B-B-----M--------E----B----E-----------------------M-------------------------o-------------X-------------------------B-o-X--BM---o-B---X------------o---------M---E--?----M--------o---------
--------------X-------------|------------X-----------------B-----E-E-----o-------------------------------o-----------?-------------------o----------------------------------------------o---------------
m----------B----------Xo----|B------------M---o-|-----o----------M---B-----------------o--------o----------?---------------------------------------?------?---?X------------??------o-X-------?---?-----
XXXXXXXXXXXXX-XXX--XXXXXXXXX|XXXXXXX-XXXXXXXXX-X|XXXXXXXXXXXXXXXXXXXXXXXXX-XXXXXXXXXXXXX-XXXXXX-XXXXXXXXXX-XXXXXXXX|XXXXXXXXX-XXXXXXXXXXXXXXXXXXXXXXXXXXBXXXXXXXXXXXXXXXXX|XXXXXXXXXXXXXXXXXXXXXXXXXXXXX
