------B------------------------o---o---Bo--------B---B---X--o--------------o------o-----M----o------------B--X--------------------------B----o------------B-----------B-B----?------------------?-----o-
-------------o-----o-----------------------o--------------o------------------o-----------o------------------------------------------------o----------o--------------------------o-------o---------------
---------o-B----M----------------o---------------------?-------------------B--o--B------------------------------------?----------?----B-------------------o---B-----------------o-----------------------
-----------------o-----------E---o--------------o-o?-B-------B---------------B---------------------B--------------------X---?----------------o----B---------------B---o------------?--------------------
---------------------o------B------B-o--M----o--?o-----------B---B-X-------------B---B-----------------------------------E-?----M-B------o-------------------------B------B--------------o--------------
---------------oX-----o----------o----------------o---o---o--------------?o--------------------E-------------------------------oB----o-------------B----------------------------?B------------------?---
--o-X--------?-------------------------------------B-----?------o-----o------------B----------B-B-----------o-?-----E----o------B----------------------------------BB-o---------------------------X-----
---------X----------o--Bo---------------B--------------------------?-------------o-------------M-o--B---------B---------------B--o--?--M---?--o----B---------------------------------------B-----------v
-------------------o------------------------o---o-o---------------------------------------------oB--o-------------o-----------B---------------------?---E-----------B-?----------------------------o----
?--------o----------------------------B--E-B---o----------------?---o------B-B------o-----o-------B--------------------o--B-----o--o-------------------E---------------o------------------------E-------
----o--------o---T---------------B-B-----------------M-o--o------o--------------BM------B--E---?---?-----------------B-------E-o-------------------------T------M------------------------------?X--E---X
-----------------|--------------BB------B--------------oBE------------------?----------------o--X--------------------??------------------------B---------|------------o-----X-X-----B-----BB-o----------
-----------------|-----------------M------------M------B-----------o---------B--|---------X-o---B--------X----o---------------o--------B-----o--M-----oB-|--------------?---M------------------?------o-
-?---M-----------|--o-----------------------o----B-----X------------------o-----B------------------Boo------oo-------------B-----------------------------|---------------?-----B------BB--o---------B---
m--T---B-----o---|-o--------------o--B------T------M----------------------------------o------------?-----oT---M----o-----o--B--o----------o--o----------------------------B--------X--------o-B-B-------
XXX|-XXXXXXXX-XXX|XXXXXXX-XXXXXXXXXXXXXXXX?X|XXXXXXXXXXXXXXX-XXXX-XX-XXXXXXXXXXXXXXXXXXXX-XXXXXXXXXXXXXXXX|XXMXBXXXXXXXXXXXBXXXXXXXXXXXXMXXXXXoXXXXXXXX-XXXXXXXXXXXXXXXXXXXXXXXXXXXXXXXXX-XBXXXXXX-XXXXX
