------------o-------------o-------------------B-----------B--------M-----------o------------------------M---------E-X-------E------B--------?-----------------?----------------B---------o----XoB-------
---------------o------M----?B-------------o----------------------------o--------------o---o-----------o--------------------------X---?---------------B-----------B--------------------------------------
-----------------------------------------------------------------------------------o--E-o---o----EB------------o--E------------------------------?------------------------o--------------------o--------
-----o-------B-o----------------------------------E-----------M----B---B-------o--------------B------------------o--------------o-------------o--------------------------------M----------o-------------
------------------B------------------------------------X--------------------o-o------?------X---------------------------------------o----------o---------------------------------B----------------------
--------------X----o--------o-------B--?------------X---------------B---oo-B-----?-----------------X---B-------------?-------------M-----------------o--B-----------o---B------E------------------------
-----B------------------------------E-------o-B-o------------------o-o--------B--------------B--------o----------------B----------------------------------------------------BB---------B--E--o----------
----------------------B------B-----?--------?-------------B-----------------------------------E---------------X-----M------M---o------------------B---o------------------------------o-----B------X----v
------B--E--------------------------------------------E-----------------------B-----------?--B-X------o--o-----------------------o-------B----------------------o-----------o-----M------o-B------------
----?------------------------------------B-M----------o---------------E-B---------------------------------B------------------------------------E-o---o---------B?------?-------------------o------------
----------o------E--M-----Bo-------------?----------?--E--E------------------------------o-------X---------------------o------o-----------------------------------oB-------B----------o------------?----
------------o------oo-----o--------?------------BX--o-------------------------------?---o------------E--X-------------------B--------B--T------------o-------------T-------T----------------------------
B--------------------B-o---?-------------B------------o-o----?o------M----?-----------------------?M------------------E-----------------|--M--oo-----------------X-|-------|o--------------M----M------o
-------o--o----B-------|B-----------------o-----o------B------------------oB----------------B-?-o---B--------B-Bo-----------------------|---?----------------------|---B---|-----M-oB-B--o-----o-------X
m-------B-------------T-o--------------T-o-------E--------------o----|-----------T----?-----------o--------B--------o---o-X------------------------M---------------|----X--|-------------?---B-o-----B--
XXXXXXXXXXXXXXXXXXXXXX|XXXXXXXXXXXXXXXX|XXXXXXX?XXXXXXXXXXXXXXXXXXXXX|XXX-XXXXXXX|XXXXXXXXXXXXXXXXXXXXXXXBXXXX-XXXXXXXX-XXXXXXXXXXXX?X-XXXXXXXXXXXXXX|XXXMXXXXXX--XXXXXXXXXXXXXXXXXXXXXXXXXXXXXXXXXXXXXX
