------------------------------------------------------X--------------------------------------------------------------------------------------M----------------------------------------------------------
-------------------------------------------------------????????--------------------------?--------------------------------------------------------------------------------------------------------------
----------------------------------------------------------------------------------------------------------------------M---------------------------------------------------------------------------------
----------------------------------------X---------------------------------------------------------------------------------------------?????-------------------------------------------------------------
----------------------------T--------------------------------------------------------------------------------------------------------------------------------------------X------------------------------
----------------------------|----------------------------------------------------------------------------------------------------------------------------------BBBBB----XX-------------------T----------
---------------X----X-------|--------------X--------B-------------------------------------------------------------------------B---------M------------------------------XXX-------------------|----------
---------o---------XX-----BB|BBBB-------------------------------------------------------------------------------------------------------------------------------------XXXX-------------------|---------v
------------------XXX---T---|-----------------------------------------------????-------------------------------------------------------------------------------------XXXXX-------------------|---------f
-----------------XXXX---|---|-------------------------------------------------------------B-------------------------------------------------------------------------XXXXXX--------????????---|---------f
------------o---XXXXX---|---|------------------------------------------------------------------------X--------------------------------?----------------------?---M-XXXXXXX-------------------|---------f
---------------XXXXXX---|---|--------------------------M-----------------------o----------------------------------------------------------------------------------XXXXXXXX-------------------|---------f
--------------XXXXXXX---|---|------------------------------------------------------------------------------------------------------------------------------------XXXXXXXXX-------------------|---------f
-------------XXXXXXXX---|---|------------------XX--------------T------------------------------------------X-----BBBB---------------------BBBBBBBB????-----------XXXXXXXXXX-------------------|-----T---f
m-----------XXXXXXXXX---|---|--------------------------------E-|-----------------------------------------EXX---------------------------------------------------XXXXXXXXXXX------------???----|----E|---X
XXXXXXXXXXXXXXXXXXXXXXXX|XXX|XXXXXXXXXXXXXXXXXXXXXXXXXXXXXXXXXX|XXXXXXXXXXXXXXXXXXXXXXXXXXXXXXXX--------XXXXXXX-------XXXXXXXXXXXXXXXXXXXXXXXXXXXXXXXXXXXX-XXXXXXXXXXXXXXXXXXXXXXXXXXXXXXXXXX|XXXXX|XXXX
