------------------------------------------------------X--------------------------------------------------------------------------------------M----------------------------------------------------------
-------------------------------------------------------????????--------------------------?--------------------------------------------------------------------------------------------------------------
----------------------------------------------------------------------------------------------------------------------M---------------------------------------------------------------------------------
----------------------------------------X---------------------------------------------------------------------------------------------?????-------------------------------------------------------------
----------------------------T------------------------------------------------------------------------------------------------------------------BBBB----------------------X------------------------------
----------------------------|-------------------------------------------------------------------------------------------------------------------------------------------XX-------------------T----------
---------------X----X-------|--------------X--------B--------------------------------------------BBBBBBB----------------------B---------M------------------------------XXX-------------------|----------
---------o---------XX-----BB|BBBB-------------------------------------------------------------------------------------------------------------------------------------XXXX-------------------|---------v
------------------XXX---T---|-----------------------------------------------????-------------------------------------------------------------------------------------XXXXX-------------------|---------f
-----------------XXXX---|---|-------------------------------------------------------------B-------------------------------------------------------------------------XXXXXX--------????????---|---------f
------------o---XXXXX---|---|------------------------------------------------------------------------X--------X-----------------------?----------------------?---M-XXXXXXX-------------------|---------f
---------------XXXXXX---|---|--------------------------M-----------------------o-----------------------------XX---------------------------------------------------XXXXXXXX-------------------|---------f
--------------XXXXXXX---|---|-------------------------------------------------------------------------------XXX----------------------------------------------BBBBXXXXXXXXX-------------------|---o-----f
-------------XXXXXXXX---|---|------------------XX--------------T------------------------------------------XXXXX-BBBB---------------------BBBBBBBB---------------XXXXXXXXXX-------------------|-----T---f
m-----------XXXXXXXXX---|---|--------------------------------E-|-----------------------------------------EXXXXX------------------------E--------E--------------XXXXXXXXXXX-------------------|----E|---X
XXXXXXXXXXXXXXXXXXXXXXXX|XXX|XXXXXXXXXXXXXXXXXXXXXXXXXXXXXXXXXX|XXXXXXXXXXXXXXXXXXXXXXXXXXXXXXXX--------XXXXXXX-------XXXXXXXXXXXXXXXXXXXXXXXXXXXXXXXXXXXX-XXXXXXXXXXXXXXXXXXXXXXXXXXXXXXXXXX|XXXXX|XXXX
