o-M--?-----------------------------oo-----o--------o------------------M--------------------M-------o----------o--------o--B---------------------------------------E--------o-----------o-------o--------
-X------o------M-----M-oo---o---o-----oE----------------?o-----------------------------------o-B------X------------o----------o---E--------------B---Bo-------------?--B-----------o--------------------
-----------o------------------------o-------Eo---M------------?----B-----o-------------------o-----------o-----------o-----------B---------------------------B-----------------------------o-----M------
----------------------------X--X-----------o--------o---------E--------o-----------------------B---EE------o----X-----E-----M------?-o---M-------------------E--o---------------------?---E--B----------
---------o--B------?----B-----------------B---------?----------------E--B-------B-----B------M--B--------E-------BB-------------------------------X---o---------------X--M------o--oo----------B--------
--------B---?----B----------o--o---------?---B----------oo----o------------------------B--B------------------------------------X------o----------o---o--B-----o--------------------M---E------?---------
--B---------------------------B----o---------------------------B---X----------?------------------------------------?--------------?--------------------------------------------o---B----B--------------B
--B------------------------B------?E-----------o-o-------------o-----B-----------------------o-E------------M----?-MX------------o----------o----o--BB-o---B------E----oE------------------------------v
------o-E-----------------------o------------------------M-----------------Bo---o---------E--------E-----------------------------o-o---o-----------------------X---o----------M---B-------------?-------
------o--?---B-----E-----E---------------o--------o--oo-M--------------------------------------o-----------E-----?--------M-------o---M---------------M--------B--------------------------B---------E-?-
----B?-----EB-------------------------o------E------o-o-?----------M---oo--------B---oE-----------------------B---------oo---------------------o-------o-----?---X-----------------------------T--o-----
-------B---------------------------------------B----------B--------X--o-------------------------------------------------E-o---------------------------------------B--------oo---B--------o--M--|--------
-------B-------o--------------------------------M-----------M--------------------------------T----------------o--B--B--Bo--B------B-----XXo----B------------------------o----o-----------------|--------
---------------?--o--------B---------------X-----M----o-----------------T-------------------------------o-----------o--------B--o------------X-|------|----------------o-----M-----------------|----o---
m--------------ooB----B--------------------------------o----------------------------------o--|-------------o-X-----------X----------------o----------o---BM---B--E-o----M----------------------|--------
XXXXXXXXXXXXXXXX-XXXXXXXXXXXXXXXXXXXXXXXXXXXXXXXXXXXXXXXXXXXXX-XXXXXXXXX|XXXXXXXXXXXXXXXXXXXXXXXXXXXXXXXXXXXXXXXX-XXXBXXXXXXXXBXX-XXXXXX-XXXXXX|XXXXXX|XXXXXXXXXXXXXXXXXXXXXXXX-XXXXXXXXXXXXXXX-XXXXXXXX
