--------------------------------------------------------------------------------------------------------------------------------------------------------------------------------------------------------
---------------------------------------------------------------------------------------------o-------------------------------------------------------------------------------------------------o--------
------------------------------------------------------B-------------------------------------------------------o-----------------------------------------------------------------------------------------
--------------------------------------------------------------------------------------------------------------------------------------------------------------------------------------------------------
-------------------------------------------------------------X------------???-------------------XXXXX---------------------------------------------------------------------------------------------------
---------------------M------------------------o-------------XX--------------------------------------------------------------------------------------------------------------X---------------------------
-----------------------------------------------------------XXX---------------------X---------------------------------------------------------------------------------------XX---------------------------
---------------------------------------------X------------XXXX--BBBBBBBB------X---XX-----------------------------M--------------------------------------------------------XXX--------------------------v
-??------------------------------------------------------XXXXX---------------XX--XXX-----------------------------------------------------------------------??????--------XXXX----------------------XXXXf
---------------------------------------?----------------XXXXXX--------------XXX-XXXX------------------------------------------------------------------------------------XXXXX--------------------------f
----------------o--------------------------------------XXXXXXX-------------XXXXXTXXX-----------------------------------------------------------------------------------XXXXXX--------------------------f
------------------------------------------------------XXXXXXXX------------XXXXXX|XXX--------------------------------------------BBB-----------------------------------XXXXXXX--------------------------f
-----------------------------------------------------XXXXXXXXX-----------XXXXXXX|XXX---------------------------------------------------------------------------------XXXXTXXX--------------------------f
----------------------------o-----------------------XXXXXXXXXX----------XXXXXXXX|XXX-------------M------------------------------------------------------------------XXXXX|XXX--------------------------f
m------------E------E-------E----------------------XXXXXXXXXXX---------XXXXXXXXX|XXX----------------------E------------------E-----------------------------E-------XXXXXX|XXX--------------------E-----X
XXXXX-----XXXXXXXXXXXXXXXXXXXXX-------XXXXXXXXXXXXXXXXXXXXXXXXXXXXXXXXXXXXXXXXXX|XXXXXXXXXXXX---------XXXXXXXXXXXXXXoXXXXXXXXXoXXXXXXXXXXXXXXXXXXXXXXXXXXXXXXXXXXXXXXXXXX|XXXXXXXXXXXXXXXXXXXXXXXXXXXXXX
