-M--B-----------BB--------------o---------------------------o-----------------B------o---M-o---------o---------o-?----M---?-----------o---------------------------------o------------X-------o----------
---------o--M----M------E--B--------------------------B--o--?-----o-----------o-----o---E-MB-----------------M--------B--------E--------------E----------------?----------------B--------E--------------
--?-----B-----o?--------------?-------------------------------------o--?-------------------?-------B--------------B----M---X----------o------X------E--------B----------------B---B---------?---------o-
------------M-----?-----------o-X----------------M----------o-------?----o------?---------------------------B----------------M-------------?-----------M-Eo-oo-------o-------------o-------B------------
---o----------------------------------------XX-----------------------E-?B-----------------------------M------------o-?B------------------B---B---oE-------X----M-o--------E---B--------------------B----
----o---o-BB---o----------------B---------------o--B---------------------------B------M-----B--------------M---o------o-------?-------B----o-----------B------------------?-----B-----------------------
-----E--M----B-o--------B----M---------------------------------------M-----------------B----M-----X----------------oo---------------------------------------?o--------------------o----B---------M------
--------?B-------------------------o-B-?--------------------o------------------------o---------------?-----o---------o--B----M--------------?-E--o-----------?----o---------o-----------?--o-----B-----v
----?----B-----?E-----?-B-B---------B--------X-------B--B----?---------------------------o---------M?-------oo---------?----o------------------?------------B-----------E--E----B----B------------------
----?-M-------------------o------------B-B--?--------------------------------B-------------B-----------o-?o-----X---------?-------------M------------B------------M------B----o-----M---B?B------B------
------B---------------?-------E-------E--------E----------------M?---BT-MT----------?------X?-----T--?----B-?---X--------------?---?--------o-----E---E------o-?---------B----B------------------T------
--?-----------------o---------------?-o-----------B----------------E--|--|---------------B--------|-------------o-------o--B--------------B----------o------------------------o------M--------B--|------
-----B---------------o-B----------------?o-------------E-B----------?-|--|------------------------|-------------------------------------Bo----?-M---o-------------o-B--------------------B-------|------
----B--Bo---?-B------------------------M-B------MM--------o----oM---B-M----?--------B-----o----------------o------X-----o------B----------o----o------o-----------------M------------------------|------
m----------------o-E-------------------Eo------oo----?-------M---?----------------o-?--o--o--------E|-------B---E--M----M----------B-------o----B-----------------------------------X--------M--B|E-----
XBXXXXXXX-XXXXXXX-XXXXXXXXXXXXXXX?XXXXXXXX-XXXXXXBXXXXX-XXM-XX?XXXXXXX|X-|XXXXXXXXXXXXXXX|XXXXXXX-|XXXXXXX-XX-|XXXXXXXXXXXXXXX-XBXXXXXXXXXXXXXXXXXXXXBXXXXXXX-XXXXXXXMXXXXXXXXXXXXXXXX-XXXXXXBXXXXXXXXXX
