-------------------------------------------------------------------------------------------------???????------------------------------------------------------------------------------------------------
-----------------------o--------------------------------------------------------------------------------------------------------------------------------------------------------------------------------
---------------------X--------------?--------------------------------------------------------------------------o----------------------------------------------------------------------------------------
--------------------------------------------------------------------------------------------------------------------------------------------------------------------------------------------------------
---------------------------------------------B------------o---------------------------------------------------------------------------------------------------------------------------------------------
-----------------?????----------M----------------------------------------------X------------------------------------------------------------------------------------------------------------------------
-----------o-------------X------------------------------------------------------------------------------------------------------------------------------------------------------------------------------
-------------------------------------------------------------------------------------------------------------------------------------------------------------------------------------------------------v
-------------------------------------------------------------------------------------------------------------------------------------------------------------------------------------------------------f
--------------------------------------------------------------------X---B------------------------------------------------------------------------------------------------------------------------------f
-------------------------------------------------------------------XX----------------------------------------------------------------------------------------------------------------------------------f
------X---------------------------------------------------------X-XXX??-------X------------------------------------------------------------------------------------------------------------------------f
---------------------------------------------------------------XXXXXX--------XX-------------------------------------------------------------------------------------------------------T----------------f
--------------------------------------------------------------XXXXXXX------BXXX--o----------------------------------------------------------------------------------------------------|----------------f
m----E------E------------------------------------------------XXXXXXXX------XXXX------------------E------------------------------------------------------------------------------------|----------------X
XXXXXXXXXXXXXXXXXXXXXXXXXXXXXXXXXXXXXXXXXXXXXXXXXXXXXXXXXX?XXXXXXXXXXXXXXXXXXXX-----XXXXXXXXXXXXXXXXXXXXXXXXXXXXXXXXXXXXXXXXXXXXXXXXXXXXXXXXXXXXXXXXXXXXXXXXXXXXXXXXXXXXXXXXXXXXXXXXXX|XXXXXXXXXXXXXXXXX
