T------------------------------E--o----B--XBE--------------------T------E---------B------o--o?---M-----------------B?-EM-----?----------------------o--TB--------------M-------B-B---------B-------E----
------------Xo--------|----T---------------X--TBX------------B--------------?------------------MB------------------------------BB---------------------?|-------o------------?-------XM-o--B------o------
-B--M-----T------o----B--------E-----------------E----E-------------E--?------------?---------------------------------------?-?-----------B---o?----B--------o-----E---------BB-------------E-----------
--?---B---|----EM-----B--B--o------------B-------------------------------M---X------------B------------B------EX-------X---B-------B--------XEo---E-------------X--------------B---?--?-----------?-B---
-E----MB--|-----------|----|oE-B----M---------|----BX----------------------------E-E---------------Eo---T---B-------X--?----------------------------------X------------------?------E----B------------o-
---------X|----X-----------?E------------o--------------E------B-|-|-B---X--------B----?-------B------E-----------X-------T-B-----E|-B----X-B-------oBB-------------------o--??-------------------X-----
---B-E----|--------B----B---oB-?---------------E--------?|B--?--B|-|-o------------B---------ET----B-X---|---M----M--------------X-----------o--------------E?-------------B----------------MX----X------
-------o?-|-------o---|B|--|------------------|--------------------o?-------?--E||---------M--M-?-------|--M-----------------TE-----------------------------?--X-----o-------------------------?---B-o-v
----------|-B--o----------|-------------------T--|-------|-------|-|--?---------------------B|---------o------------X----B|--------|-----------?---B-|-------X-|-|--o---B-BB-------?----------------T---
--------E-|E----o---------|--------M----------|--|-o----B?-------|-|--M--------B-------T---|------B---o-|B---------------E----------o---------------------o-------|--T----B-B----------B-B-------o--|---
-----B-B--|B----------|o|-B|-------?-------|---X-----|---------B--|--X--E---------------BB--X---------B-|---------X--------X-|B------------B----------------------|--|-----------E--------------E---|---
----------|--MB-----------||--o-----X---------|B--o------|-------X------------|-||-----?---|--T--------------o------oE------M-|-?---|--M|-------------|----------?--------------|-B---?-T----|--B---|--T
---?------|--B---E------EB|-B-T---E----------E|----------|-----------------------o--B-------M---BXE-----|--oo----------------|--------------------X------E----E---|-X|---M----E--o-E?o--------------|---
-----T--o-|-------------E-|-B-------B---------|--|M-X|---|B------|-|-----E------X--?---|---B-|----oEB----B--------------?E|------X-|?B---B------------||---------E--------------|-------|--X--------|--B
m-?--|----|-----X------T--|-----M--E-------T--|--|---|-M--------|-|---|----------------B-----E---------o|-B-----------------?|------BEo------XE---o---M--?-E------|--|---------E--EE---------BX-----|---
XXXXX|XXXX|XXXXXXXXXXXX|XX|XXXXXXXXXXXXXXXX|XX|XX|XXX|XXX|XXXXXXX|X|XXXXXXXXXXXXXBXXXXX|XXXXX|XXXXXXXXXXXXXXX|XXXXXXXXXXXX|XXXXXXXX|XXXXXXXXXXXXXXXXX-XXXXXXXXXXXXXXXXXMXXXXXXXX|XXXXXXXX-XXXXXXXXXX|XXX
