--------------------------------------------------------------------------------------------------------------------------------------------------------------------------------------------------------
--------------------------------------------------o-B---------------------------------------------------------------------------------------------------------------oo-------------------------XB-------
------------XXXXXXXX------------------------------------------------------------------------------------------------------------------------------------------------------------------------------------
-------------------------X--------------------------------------------------------------------------------M---------------------------------------------------------------------------------------------
----------------------------------------o---------------------------------------------------------------------------------------------------------------------------------------------------------------
--------------------------------------------------------------------------------------------------------------------------------------------------------------------------------------------------------
------------------------------------------------------------------------------------------------T-----------------------------------------------------------------------------------------------X-------
-----------o------------------------------------------------------------------------------------|--------------------------X-------------------------------------------------------------------XX------v
--T---M----X----------------------------o-------------------------------------------------------|------------------------------------------------------X--------------------------------------XXX------f
--|-------XX-----------------------------------------------------------------------------B------|--BBBBB----------------------------------B----X------XX-------------------------------------XXXX------f
--|------XXX-----------------------------????????-----------------------------------------------|-----------------------------------X----------------XXX------------------------------------XTXXX---?--f
--|-----XXXX------------------------------------------------------------------------------------|-----------------------------------XX--------------XXXX-----------------------------------XX|XXX------f
--|----XXXXX------------------------------X-----------------------------------------------------|-----------------------------------XXX------------XXXXX----------------------------------XXX|XXX------f
--|---XXXXXX-----------------------------------------------------------------------XXXXXXXX-----|---------------------------XX------XXXX----------XXXXXX---------------------------------XXXX|XXX------f
m-|--XXXXXXX-------------------------E------------------------------E--------E------------------|----------E---------------------?--XXXXX--------XXXXXXX--------------------------------XXXXX|XXX------X
XX|XXXXXXXXXXXXX----XXXXX---XXXXXXXXXXXXXXXXXXXXXXXXXXXXXXXXXXXXXXXXXXXXXXXXXXXXXXXXXXXXXXXXXXXX|XXXXXXXXXXXXXXXXXXXXXXXXXXXXXXXXXXXXXXXXXXXXXXXXXXXXXXXXXXXXXXX-------XXXXXXXXXXXXXXXXXXXXXX|XXXXXXXXXX
