--E-----B-----B------------E------------------B--?B----------X-B-----o---------------X---E------o------o------o-------o--o----------------o--------------------X---------------B--o---------------------
--o---------B-o-o------X---o----------?-------------------o---------------o?B-----------?--B-------B--o----------------------------------E--------------?B----?--?------M-------------o-----------------
X-------?----oB----------o------------B-------------o---o-------o-----------o------------------------o-----------------X--------B----X----X--XX----------------E--------o--E-----------------M-o--E--Mo-
--------------o-o---------------------------------E-----X----o--------------------------------E-----------M----o----------------o----E-----o-------o-------------------------------B---------------Bo---
-o-------------------------o-o--oo-------------X--------------o-----------?---------------B------o----o---------B--------------------X--------------?------------------------------------------E--------
--------o--o------X-E----------o-------o?---o-Bo----o---------------------E-------EB----o------------------o-o-E?E-EB---X-----------o------------o--------------B------?-----------B---------------?----
-oB----------------------oM--------------------o------------------X--?--------B-----BE---------------?-----o--o----------------X--------------------B--------------------B--o-------------o----o------M-
-------o--X---------------------M-----------M--------------ooo----------o----------------------------------------o----oB---------------------B-------o--------------------E-------E-----E--------------v
------E------o------B---B------o----------------------M-------X---X--o-----------------------o--X--E--------o--------o---------------------B-------o-------?---------E--------B--------o-----B----------
------------E----------o-----------o-----B---X-----o-B--B-X-----o-----o---o-o-----o---B-B-----------B----------B----o----------------------------------E---X-----------o--B-------B--B------------------
---------------X----o---?---o----T--------B----X-----------------------------o----------------X-------ooM---------T-----o----B--o-------------?-------------------o-----------------o---B-----------o---
---o-------X--o----------X----o--|-----o-----------------o-----o-------?--B-------?---E--------T----------------o-|---------------o----o----o---------------B-----------------------------o---------o---
--------------------o----------o-|M--------------------?----B----------------o-----------------|---E-o------------|-------o---oX-------------BB---------X--------------------o-?---o-----------------B--
B---------o----o---o-------------|---------------------oX-----------------------?-o------------|-------------?----|-----oX-?----E------B---------o----B-X------o--o--------------T-------------B-----o--
m---T-B----o?----------X-B------o|-E---o--------------------------o-----B-oT----E--------?-----|------------------|--X----E-X---------E-o----?-----------------------------------|--------------o-------
XXXX|XXXXX-XXXXXXXXXXXXXXXXXXXXXX|XXXXXXXXXXXXXXX-XXXXXXXXXXXXXXXXXXXX-XXXX|XXXXXXXXXXXXXXXXXXX|XXXXXXXXXXXXXXXXXX|XXXXXXXXXXXX-XXXXXXXXXXXXXXXXXXXXXXXXXXXXXXXXXXXXXXXXXXXXXXXXX|XXXXX-XXXXXXXXXX-XXXXX
