--o----------B-----EB-o-----------BM----------X-----o------------------------o--------------oo-------------------B---------B----------------X----oE-----------------------------o----------?-------B----
o----------------------B---E-?-o---oB---------------------?---------B---B-------------?---B-o---------------------------------------B--------o---------B--------oo-----------B--o--------E-----?-------X
------------------------Boo----------------o-------------E---------------B------------o---oB------------------------o-----------o-------------------------------------o-----------o-----Bo---o----------
--B-----------B-o--o----B-B-o-----------------B----o-----?---EB----X-----o----B-BX-----------o-o-o-------------M-----------o-------B--------------B----------------o--?---------o-----------------------
---BB-E--X--o--------X------------------------E--oo-------------B--------------------------o-----o-------o--o--------Xo---------------B-------E-----------------------o---Mo-o---------o?---------------
--------o---------------------------------o-B--X------------------------------------------o------------------------------------o-----oX---------------------o---B-------------B-B----------------?------
---------B-------B--XB---------------------------------------------B-------?-M-o---------------M-------------B---o------------------E-----------------------------X-------?----o---------B-----B-o------
?-------B--------------------o---B---------------------------------------o-----------o------------------------------E------o-?E----B-------------------------------------------?-----E------o--o--B----v
--------EoX-X----------B---?---------------------E--------o-------X--Bo-----X-o-----------------------------------------o-----ooB----B---------o--E-----------o----------------------------?------------
---o-----X---o-----oB------E----------------------------B-----X----E-o---B---B--E-----o-----X--------B-----M------------------------------------------------B----E-------o------------------o-----X-----
------o-o----------T-o--o-?--B-X--?-------------------------BXo--o-------BB-----XX-----?-------------B------------------o--------------------o------oB----------X----------------B----------o--------BB-
----o--B-B--o--XX--|----------o-o------M-o--o---------------------------------o---------------------X-----oo--B---E-B---o--o--------B-----------------o---o--------oo-T----o---o?--------?--o--?--?-B---
-------o-----------|----------------o-------------------------M---T---------B----------X--E--E---o----------------------M-------------------E------X---------B------Bo|E--------------------------------
-------------------|---------------------------------------o------|-------B---Xo--o-------------------?--o--oo-----B----B-------------o-------M------o----------------|----B---?-M---------o-oo---------
m---B-------E------|--------B-------------------o--------------oo-|-----------o-----------oE-------------E-------------------------------------B-X--B-----o-----------|o--------------------------------
XXXXXXXXXX-XXXXXXXX|XXXXXXXXXXXXXXXXXXXXXXXX-XXXXX-XX-XXXXXXXXXX-X|XXXX-XXXX-XXXXXXXXXXXXXXXXX-XXXXXX-XXXXXXXXXXXXXXXXXXXXXXXXXXXXXXXXXXXXXXXXXXXXXXXXXX-XXXXXXXXXXXXX|XXXXXXXXX-XXXXXX-XXXX-XXXXXX--X-X
