--------------B---------o--o--------------------B---------------X---------------?--B--------X--------o--B-----------------------------E--------B--o---o-----------------------------Bo------?o----------
------------oE--o-------------------------------------------------------------M-o----o--------------------o-------o-------------o--M---------oX----o--B--------E-o---o----------o---B-------------------
---------?--------------------------------o---------M--Bo---o---------E---o--------------------o---o-----------------o-E------?---o----M-----o---------B-----------------------------E------------------
o----o------------?---------X----------------X-o?------------o----------------------------------B--o-----X-o-------------o---------E---o--------o---------o-----o-----?-o------E------------oM----------
-o---------o------------o-B----o------------X-o---------E------------------------------B----------X--o------------------o-------o----M---------B---o------------B-------o---oo-----o-------------o------
o--------X--o----------------------o--o---------?----------------------------------B--oo-------B---oB---------B----M------o-X----------------------B--------------E------X--B----oB---B-----o-----------
-----------------------E-----B------B-E----B----o-------o--B------?---oEo--o-----------o----------BE---------------------------X------o---------B--o------------B?------------------------o--------B-B--
---------o-----B-----------o----------o----------M---------------B---o---------o-----------------o---XB------M------X------o------------o--------X-------o-o-----------------------X-----o--B----------v
-?---B------o-----o---E------------------------------o---------------------B------------------------BX-o--o----------------------B--E--B----------o---------------------BX---------------------o?-------
---B-------?M-----------o---------------?----------------X-----o----o--X------------B----------E---B---B------o-----------------------o------------?-?---o-----------------------------------o---oo-----
-------E-oo----BE-o--------------------T---o---------T-----?M----------o----------------------------o-----o------o---T-----o-------------M----T----------B--------X------o------------------?-----------
------o-----o------?-o--B---T--------B-|-------------|------o----o-o---o------------------------o-------o------------|--o-----oT-----X-------o|-------------------------------------o-------------------
---o---B------------?-------|---o--M---|B----X--?----|Bo-o------o--B----------BE-------------E--o---------------?-o--|----o---o|--------------|-------------?----------B-E--o-E------o-oT---------------
----------Mo----------------|----B-----|-------------|---------------------oXB--------------------o-o----------------|----B----|Bo------------|-o--B-X-----------------B?o-----XB-------|---------------
m------------------o--------|-X-T-E--T-|----o--------|--B-----BT----------M---------B-o---------Bo---B-----E---------|-----B---|---o-------o-T|---------o--o--------M------B----BB------|---------------
X-XXXXXXXXXXXXXXXXXXXXXXXXXX|XXX-XXXX--|X-X-XXXXXXXXX|XXXXXXXXX|X-XXXXXXXXXXXXXXXXXXXXXXX-XXXXXXXXXXXXXXXXXXXXXXXXXXX|XXXXXXXXX|XXXXXX-XXXXXX||XXXXXXXXXXXXXXXXXXXXXX-XXXXXXXXXXXXXXXXXX|XXXXXXXXXXXXXXX
