---------------------------------------------------------------------------------------------------------------------------------------------------------X----------------------------------------------
--------------------------------------------------------------------------------------------------------------------------------------------------------------------------------------------------------
--------------------------------------------------------------------------------------------------------------------------------------------------------------------------------------------------------
--------------------------------------------------------------------------------------------------------------------------------------------------------------------------------------------------------
--------------------------------------------------------------------------------------------------------------------------------------------------------------------------------------------------------
--------------------------------------------------------------------------------------------------------------------------------------------------------------------------------------------------------
---------------------------------------?----------------------------------------------------------------------------------------------------------------------------------------------------------------
-------------------------------------------------------------------------------------------------------------------------------------------------------------------------------------------------------v
-----------------------------------XX------------------------------------------------------------------------------------------------------------------------------------------------------------------f
-------------------------------------B----------------------------------------------------------------------------------------------------------------------------------------------------------X------f
--------------------------------------------------------------------------------------------------------------------------------------X----------------------------------------------------------------f
-------------------------------------------------------------------------------------------------------------------------------------XX--------------------o-------------o------o----------------------f
-------------------------------------------------------------------------------------------------BBBBB------------------------------XXX----------------------------------------------------------------f
---------------X-------------------------------------------------------------------------------------------------------------------XXXX---------------------------------------------------------------of
m--------E---------------------------------------E--------------------------------------------------------------------------------XXXXX----------------------------------------E--------------E--------X
XXXXXXXXXXXXXXXXXXXXXXXXXXXXXXXXXXXXXXXXXXXXXXXXXXXXXXXXXXXXXXX---XXXXXXXXXXXXXXXXXXXXXXXXXXXXXXXXXXXXXXXXXXXXXXXXXXXXXXXXXXXXXXXXXXXXXXXXXXXXXXXXXXX--XXXXXXXXXXXXXXXXXXXXXXXXXX-------XXXXXXXXXXXXXXXX
