------------o---X----B----------------o----------o----------------EB-----E--o------------o------------B--------------?----o---------oo---o-----------------------B----------------------o---------o-----
------------------------o--------------------B---B-------------o--------B-------?-----------o----------------------o-B----o--------?-------------oB-----X-----------o--------------E------oB---o-------o
-----o------------------o--o---------o---------------------------o-----B---------BXE--o-o--------o------------------?B------B----o-o----------o---------oB----------B---------?----o-----------------M--
-o------------B------B-------------------------B--------B-B-----------------o----o--------o------------o-------------------o--------------------------------o-----------E----------------Bo--------o----
-----o----------X----------------------------------------o----------------X-------------o----------o----------o----------------?B----o------M-E---------B--------------B--o---------------X---?-o------o
-?-o-----X-----------------B-?--------o-----o-------E-------o--------Eo?--------o--B-----------------o----B-----?---B------------------------o-----------------o?-----o--------o------B----------------M
--B---E----------------------------B---------------------o-------o------------M------------o-------B--------------------------------------------------------------------o----B-----o-o--o-------o-------
------o------------o--B----o----------?--X-------o-------?---------------------------------o------------------X-------------------?--B---------------------o---X------------E--------------E--------?--v
-------B--------------------o-----------B---------------------------B----------------o------------------o--------o-o---------B-------B------E--o------------------------------o-o-Bo---------o-----M----
----------------?------------M----o----o----o--------o--B---------B---------------E-oX------B--------------oo----M---------------------------o-----------M--------------------XM----------B---------o-o-
---o--?------------B----o--------E-------o-----Xo-----?-------------X--------------o------o-----B-T-E-o-------------------------------------o------B--------X---o-----o-----E---------------------------
----o----------E------E---o---?----E--------E-o-------------------------------------B-----------?-|---------------------X--X---o--?--------------T------------------M-----------------E-----o--------T--
---o-E--B----------------------------------B-------------B------o----------oE----------?----------|-----------------T-o----------------------B---|--------T-----------------o-----B-----o-------X----|--
----------o--------B--------o-------------M------E-----------T------Xo----------o----------o------|--E-----o-B------|----BE-----------B---T------|---EBT--|o--------------------------------B---o--o-|--
m----------E----o-----o-E------Mo----------------------------|---------------o--B-----------------|------?---X?-----|-------T------------B|------|-----|--|X---------E------o---o-E-------o-----o----|--
XXXXXXXXXXXXXXXXXXXXXXXXXXXXXXXXXXXXXXXXX-XXXXXXX-XXXXXXXXXXX|XXXX-XX-XXXXXXXXXXXXXXXXXXXXXXXXXXXX|XXXXXXXXXXXXXXXXX|XXXXXXX|XXXXXXXXXXXXX|XXXXXX|X--XX|XX|XXXXXXX-XXXXXXXXXXXXXXXXXXX-XX-XXXXXXXX-XX|XX
