-------------------o-o-----o---------------oM----B------?-------------------o-------o------------------oM-------o----------------------------------o--B----------------------o--B--?-----B-----?--------
------------X--o--M--o-XB--o---------MX------------------B--B?--------o-------------E------B----Bo----B----------?--------X--------o?-E-M-------------------B------------o-------BoB---M--------B-------
-E-----o---o-------o----------o------------------o----------X----------------------------o------B------------?----------------B----------------------------------?------------------X-------------------
---E---XB----------B-------o------------B-----o-o---------------------------------------Bo------------?-E-E-oB---X--o-------------------------------------------?---------------------?------o----------
----E-o---------------------X-----------B-o---o-------X---------?-----o---------o---o-----B------------------o--B---------o----o---------o----o-----------------oB--------o--?--E------------------X----
----------?------------------o--------------------B--------------B-o-------o--B------------------o---o-----X--------------------------------o-------?----o-----B--------------B-------------B----E---B-E
--------B---o-------------o--------?---------------B--------------?-----------------?----X-B----o----o--------------------------------------------?-o-----------------o--Xo-o-X?Xo---E----?----------o--
--------o----------B---E---------------------------------------o------------B--o----------o-----------B-------------?-----------------o------------o--o-------o-----------------------o-----o----------v
----------o--o---------o------o?------------B-----------o--o-------o---B----BB--?----------------------B-----------o--o-----o-----------B-o----------------oo--------------o--B---------------------E---
--X---o------------M------------B------B---------------------o--o---oo-----o---------o-----B--------------?-------------------------?o-----------------------------B----X--o-----------o----o-----o-----
-B-----------B-----------o-B---E--o-M-----oo------E------------Eo-o--------X-----M-oo?-----------------B------o-------------------------------B---BX----------------------------------T-----------------
--------------X-T-----?------------o-XT---o------------B------------------------|-----X------------M-B-----B-----------o-------------B--X-----o-------------Bo----o-B-----------------|-----------------
-----B-o--------|-B----------B--------|-----------------------------------------|---------------B-----------------------------E---------o---------------o-------------X------o------B-|-?---B----------T
----------o-----|--X---o--------X-----|-------o-BB-------------------o----------|----------?---------B-------o-------o-----B----o-----------XM---o-----------------|o-o---------------o----------o------
m-------------M-|?---B---------------o|---o----?----------------E---------------|-------------------E----------B-----o--o---o-------oB----------------BX-----------X---------B--|-----|--------B--------
XX-XXX--XXXXXXX-|XX-XXXXXXXXXXX-XXXXXX|XXXXXX-XXXXXXXXXXXXXX-XX-XXXXXXXXXXXXXXXX|XXXXXXXXXXXXXXXX-XXXX-XXXXX-XXXXXXXXXXXX-XXXXXXXXXXXXXXXXXXXXXXXXXXXX-XXXXXXXXXXXX|XXX-XXXXXXXXXXXXXXXXXXX-XXXXX-X-XXXX
