----------B----B----------------------------B-----?--E----------B-----------?------B-B--?---oB--------o--B-------------------------BB---------------E-------B----------B----------o--o---?--------X-o---
---------o-B--B-------------------o--------o----------------o--X-------------------o---------------BE-o---o------------------B--------B---------o----o-------------E---------o--------------------------
-------B--E-----E-----------------------o--------------B-----------------------B-o-------------B--------------B----------E--------------o-------------------o-----------B-------B----------E------o-X-o-
-----------o------o-o-----o-M--o----------------------------------------------------E---o--o---o---BB-----------------o---------------------?-----------------o-----o--------------------o------o-------
-o------o--?------------------?---------?--o---------------------------------------X-B---------X--?------------o-o----X----------X--------o--------------------------------B-----------M----B------o--o-
o------------------o-B------o------------M-------M---o-M--?---?------o---------------E----o----------BB-------E-oE---------M------------o-------X---------B------o-----------X--o---?--------o?--o------
------------E----X--B------------o----------o------o-o-------------B-B---------o-------------------B-EoE--o----------o-----B---------------E-E-----------------------B-B-------------------Bo-----------
----BB--------------------------Bo---------E--BX--------------------------o---B--------------------X------o----o-------------o-o-X----o---------------------o--------B-?o------o-----------------------v
B-o--B--BB----------o---X--o-----B---?---------------B----------------------o------------------B-----------------------------Xo-o----------------------o---?------------------?-------------B----o-----o
------------------------------------o--------------------------------B----------------o------BX----------o-------o-----------E-E-------o--------o-Bo------o-----B-------o-------------------B-----------
----------------------M-X-------o--M------X-----o-------------------------o--o------------o------B---T-T-----?-----B----B--X----o------------------------o-----BE----Bo-----------o-B-------------------
---------E--o-----------------o-----o--??--------o----------------BT-T-------------------------------|-|--o---------E-----o-----------------------------------T--T---------B--------o-------------------
-----------------------o----------M--------B------------------o----|-|---------o-X---o-o-------------|-|-----------o------------------------------------------|--|-------------?------o-----------o-----
----------o--------------------------T---B-------o-o---------------|-|---------------?o-o-----B------|o|----------------M-----B-----o---------------------o---|--|o------------------------B-----EM--o--
m-----o----------?-------------o---o-|----E-----------------------o|-|--M----------------------------|-|--X---Eo-B------oX------------X?-------B----o---------|-T|---------------B------o---E-------?---
XXXXXXXXXXXXXXXXXXXXXXXXXXXX-XXXXXXXX|-X-XXXXXXXXXXXXXXXXXX-XXXXXXX-X|XXXXXXXXXX-XXXXXXXXXXXXXXXXXXXX|-|XXXXXXXXXXXXX-XXXXXXX-XXXXXXXXXXXXXXXX-XXXXXXXXXXXXXXX|X||XXXXXXXXXXXX-XXXXXXXXXXXXXXXXXXXXXXXXX
