-----o-----------o-----------B--B-----BE---------------------------------------------M------o--B--------B----?B----------------------B?------E-----------o----o-----o-----o-----B------------o--?-------
-M-----------E----B-----Bo----B----------------------E---B-o------------o--o-------------------------?--M---B------------------------------------o-----------------B-BX---B?-o-------o--------o---------
-----------B------------------o----?----------------------------------------------o---o----------X-------------o--X----?-----------------------B---------------B-------------oo------------------X------
--EB-----------------E----------------------o------B------B------X--------------o--------B-o-----B--B---------o---------------------------oM--------o--B-------------B------?---------B-----------------
----B--------------?-------------------o--?-----------------o--o-------------o--Eo------------------o---------E---------o----------------------M-----B--------------?-------o-------------------o-M----o
----------------------------------?---------o---------------B---------?-----?------o-X--------oX-----?---o--------------B---------------------------ME----o--------------ooo----------E---------?-----?-
---M--X----M-Eo--B-----B-------------------?-o--E------o----------------B---B--------M-----B----B-------X-----------MM----------o----------------X-------------------------M----------------------o-E---
-----?-------Bo--------------M---o-------------o----------oo-?-------------------------------------?------------------------------------B-X----------------------------X-----o----Bo-----M-?-----------v
--------o-------o--------E---o-----B------o-----------X---o-----------------------E-o-----o--------------------------X-------------B-o-------------o-----B----o-------o---------------B-----------------
-----------------------------B------M-------B-----------B-E----Bo------------B---------o------------------X---o--------------------------------?--------E--B------------------------------------B-------
--------M--B-----------?--------------------o-------B-E--?-------------M---------E------X---------M---------------------------------------o-----o-----------------------o-------B------------------M----
--o----------------------------B----E-------------------------------------------------o--X--------------o--------------------------T-B-------------------o---------|------------------------------------
-----------------------o-------o------------------B----------B--------T--TB-----------o------oo---B----E--------o---------B--------|----------------o-------------------------------?-----B---o--?-o----
----B-B------------B---o---M----------B-----?---o------------M-----o--|--|--oB-MB-----T------B--------o-----E---------X-B--------o-|--------?-------|B-----X-------|----------------------------?--E----
m------E-----------------B---------------X--o---------------B-------X-|--|-----------T|-----?--------oX---------B---------o--------|----------------|--------------|--B-------------------B------M------
XXXXXXXXXXXX-XBXXXXXXXXXXXXX-XXXXXXXXXXXXXXXXXXXXXX-XXXXXXXXXXXXXXXXXX|XX|XXXXXXXXXXX||XXXXXXXXXBXXXXXXXXXXXXXXX-XBXXXXXXXMXXXXXXXX|XXX-B?XXXXXXMXXX|XXXXXXXXXXXXXX|XXXXXXXXXXXXXX-XXXXXXXXXXXXXXXXXXXXX
