-----------B---------------------M-o------------------BB--------------E?o------M-B--------------X-----o-o------------B-----------?---------------B-oM---M------------------o-o---o-B----------------o---
--------o------------------------B-------B-----M---------------B-----B----X--M------------M-E--?------------------B-------o----------------M-----?---------M--?----B-o--------o?---?--B-----------------
-----------------------------------M------------------------B------o--o-----------E-----------------------B--------MB------------------o-------------?---B------------M-----o-----o---------------------
-----------o-----------Bo------------o---B---------B-B---B--------------M-------------Bo--------M-------B---B------------o------B--B------------o-----------B-B-----------------B--o---------------B----
-------------B---B-----------------------o----B-------------o---M------------------------------?---E------------?--------------o-----o----------------o-------------------B---?-----o-------Bo----------
---------oX----B-----X--------------o----------B--B---------B---------?--------------X-?-----------------------o---B---o-----------------------------------M------------B----?----?---------------------
-----oM-o------Mo---X---------------------o---B----B----------o------------?------------B-o--------o------------------E----?---------------?--o--M-------E-o-------B----------B--------------o----------
-----------------------M--o-----B--Eo---------o---?-------B--o-o-----o--o-o-----------BX--o--------------o-----------------B-------------------o-B--B------M--o---------B--B-------------------------?-v
----Xo----B--------------------?--------B----------------B-----------?--B-------B-----------------------------E------B-X------------------------------------------------------o--------B?---------------
--B----?---X--------o----EB-----------------MBB-X-------------?---M--------------B------M-------M-----------------?B------?------E------------------?------------------------B------B-----X--------B----
-----B----------E---------E----------o--------?---------B--o------B-------------------o-oo----------------------oX----------?----------------B------?--------------------M-M-------------Mo---------B---
-B-o?--X----B----------B----------M----------TE-o---------------o---?-----oo------------E-B---------------------B-----?B--B-XX---------------------o----------o----M-----B----B---------o--------B------
-----------E-B-B---------B-------------------|----o-------B--B--------------------------------------------o----B--o----o---o----------------------------------------------B-----M----B-?-----------o----
--o------------------B-------------------o--M|-o-?---------?----M-----------------------B-----------------------X--------------------------------o----X-E-------------B------|---------------------X----
m?----------?---------------------o----------|?------B------------X-M--------B---------X--B---------B--------------------o-----o--------------B------------BB-------------------o-----------------------
XXXXBXXXXXXXXXXXX?-XXXXXXXXXXXXXXXXMXBXXXX-XX|-XXXXXXX-XXX-XXXXXXXXBXXX-XXXXXXXXXXXXXXXXXXXXXXXXX?XXXXXX--XXXXXXXXXXXXXXXXXXXXXXXXXXX|XXXXXXXXXXXXXXXXBXXXXXXXX-XXX-XXXXXXXXXB?XXXXXXXXXXXXXXXXXXXX-XXXX
