-------------------------------------------------------------------------------------------------------------------------------------------------------------------XXXXXX-------------------------------
--------------------------------------------------------------------------------------------------------------------------------------------------------------------------------------------------------
--------------------------------------------------------------------------------------------------------------------------------------------------------------------------------------------------------
--------------------------------------------------------------------------------------------------------------------------------------------------------------------------------------------------------
-----o-----------------------------------------------------------------------------------------------------------------------------------------------o--B-----------------------------------------------
---------------?---------------------------------------------------------------------------------------------------------------------------------------------------------------------B------------------
---------------------------------------------------------------------------o----------------------------------------------------------------------------------------------------------------------------
-------------------------------------------------------------------------------------------------------------------------------------------------------------------------------------------------------v
-------------------------------------------------------------------------------------------------------------------------------------------------------------------------------------------------------f
-------------------------------------------------------------------------------------------------------------------------------------------------------------------------------------------------------f
-------------------------------------------------------------------------------------------------------------------------------------------------------------------------------------------------------f
-----------------------------T---------------X---------------T-----------------------------------------------------------------------------------------------------------------------------------------f
-----------------------------|-------------------------------|----------------------------------------------------------------------------------------------------------------------------o------------f
-----------------------------|-------------------------------|-------B----------------????????-------------------------------------------------------------------------------M-------------------------f
m----------------------------|------------------E------------|-------------------------------------------------------------X------------E-------------------------------E------------------------------X
XXXXXXXX--XXXXXXXXXXXXXXXXXXX|XXXXXXXXXXXXXXXXXXXXXXXXXXXXXXX|XXXXXXXXXXXXXXXXXXXXXXXXXXXXXXXXXXXXXXXXXXXXXXXXXXXXXXXXXXXXXXXXXXXXXXXXXXXXX----XXXXXXXXXXXXXXXXXXXXXXXXXXXXXXXXXXXXXXXXXXXXXXXXXXXXXXXXX
