------------------------------------------------------------XXXXXXX-------------------M------------------o----------------------------------------------------------X-----------------------------------
----------M---------------------------------------------------------------------------------------------------?-----------------------------------------------------------------------------------------
----------------------------------------------------------------X---------------------------------X---o---------------------------------------------------------?---------------------------------------
---------------------------------------------------------------------------------------------XXXX???????-----B-----------------------------------o---------------------------------------------X--------
-------------------------X-----o-----------B------------------------o--BBBBBBB----------------------B--------------------------------------------B-M-----------------------------????-------------------
-M------------------------------------X-----------------------------------------------------------------------------------------------------------BBB---------------------------------------------------
-------------------------------------XX------------o-------------------------???????B-----------------------------------X----------------??--------------?----------------------------------------------
---------------------------o--------XXX------------------------XX----------------------o--------------------------------------------?------------------------------------------o-----------------------v
-------------------T---------------XXXX----------------------------------------------------------------------------------------X----------------------------------o------------------------------------f
-------------------|--------------XXXXX-----o----o----------------X------o-------------------------------------------B--------XX-------T----------------------------------T----------------------------f
-------X-----------|o------------XXXXXX---XXX--------------------XX---------------------o-----------------X------------------XXX-------|------------------?????-----------|----------------------------f
-------XX--------B-|------------XXXXXXX----------BB-------------XXX---T-----------------M---T-------------------------------XXXX-------|----------------------------------|----------------------------f
-------XXX---------|-----------XXXXXXXX---------------------XX-XXXX---|--------------------M|------------------BBBBBBBB----XXXXX-------|----------------------------X-----|----------------------------f
-------XXXX--------|----------XXXXXXXXX-----------------------XXXXX---|-----------T---------|-------------------T---------XXXXXX---X---|M---------------------------XX----|----------------------------f
m---B--XXXXX-------|-------E-XXXXXXXXXX------------E-E-o-----XXXXXX--E|-E----E----|-------E-|E----E----------E--|-???E???XXXXXXX-------|----E-----------------------XXX--E|-E-------------------------oX
XX---XXXXXXXXXXXXXX|XXXXXXXXXXXXXXXXXXXXXXXX---X--------XXXXXXXXXXXXXX|X-------XXX|-------XX|XX-XXXXXXXXXXXX----|XXX--XXXXXXXXXXXXXXXX-|BXXXXXX--XXXXXXXXXXXXXXXXXX?XXXX--|----XXXXXXXXXXXXXX----------X
