--------------------------------o--o--------------------B------------------------------B----------------------------o--o-------------------------------------o-------------E---B------------------o--o--
---E------------------------------B-----------------------------B---------------------o-----E--------------------E-X----------------------------------------E----o-E-----------------M------o-------BoB-
----------X---B-----------o-----o---------------B-B--o---B----B----------------------------------------------o------------M---------X---EEo----?----------------------------E--E------------------------
-----o----------------E-B----X-------E-----------------------------------------o-------------------o------------------------------B----M---o--------o----------------------------------B----------------
----------------------M----B---B---------------------------------------------------------------------------?------------------------------------o----o---------------B----B--------------?---?----------
-------?-----------------------------B----------B-M------o-X--B--------------------------------B-------------------?---------------?-B-----o-----------------B--------------B----o---B-------o----------
----------M-----o--------X------------o---------------------------------------o----------------o--X----------------------------o---o-E---o---------o-------------o----------------------------------EE--
---------o---?-----------B--o----------o------o-------------------------------------?o---------E--------B-----------------------------?--------------o-X----------------------------------------B----o-v
--?--------o------E-------o----o---B------------------B-----------------------------B-oo------------------E--------------------------------------------------------B----o--o---E------------------------
--o--------o----o----------------B-------?---------B-o---------------------------------o-----o-------------o-----------E-----?---------B-------------------------o------------M---B--------X----o-------
--------B-B----o-M----T-------o---------------?-------------X----------B----------X?--M-------------E-----------------------o--B--?---B--------X-----------------o-----------B-------o------------------
------------X---------|--------------------------------------------Eo--o---------------o------------?------------o---o----------------------o--------B-----------------------o-------B----B-------------
-B--------------------|-o-----------------------oT---------------------------B-X-------E----------------------------B----------------------------------X---------B----------------------X---------------
-------------o-------o|---M----------------------|-------E-----------------------------------------------------------------B-B----T--------------o---------------B-----------E---o----------------------
m-X-------------------|--o--------?--o-----------|-------T----------------------------o-------T---o-------------------------------|-----------------B------------o------------------B----------------B--
XXXXXXXXXXXXX-XXXXXXXX|XXXXXXXXXXXXX-XXXXXXXXXXXX|XXXXXXX-XXXXXXXXXXXXXXXXXXX-XXXXXXXXXXXXXXX-|XXXXXXXXXXXXXXXXXXX-XXXXXXXXXXXXXXX|XXXXXXXXXXXXXXXXXXXXXXXXXXXX-XXXXXXXXXXXXXXXX-XXXXXXXXX-XXXXXXXXXXXXX
