------------------------X--M-----------o--------o--M-o--M---M---B----B------o------------------------BB---o---o--------o---------o----o--------M------------X-------------M-----------------------------
-B-----X-o----B-------o---------------------------------o--?---------------------?-------------o-M------------------o-------o------X----------------------o---------------X----o-------------X----------
------------------------------B---------------------------o-----?------E------------E--o-M--------------?-X----B--?----o--o--------------BB-B-----------------oM---o---o----------------oX-------o------
------o------?-------------o?-----o------o---------E-----E----------o----o--M--Bo--------?E----o----o----?--------------------------M-X-----B--------------E---?-----B-------B-------------?----M-------
----o-------o---E----o?----oo--------o-E-----------------------------o----o-----------------?--------------X--B---Mo-----o---E--B-------B------E---?---M------------X-------------M----E-----------M----
---B-----------oo-------------B---?---------------B-oo-----o---------o------------------------------o---------Eo--X--------o------------o-----------------oX-----?o-----E-----o-------E----------o------
--------------------oo---E--o-----o-B----------o-----M--BB-----?------------B--B------------B-------------o-o?--o---------------------o------o---------o-----o----X-----------------o----EB--X------B---
--------?-o----o--Xo--B----X-------?-o--------B---o----?-------------X----------X----B-----------------E--------X--------o--B---B------X---B--------o------------------B----------------------B--------v
---------------E------B--------------o----------M-?--B-----------?----X--------B--E---o--------?------------o------o?-----o-----------o-----------B-B---B---B----------------X-o-----------?-Bo---------
-----------------X-----------------o-?--------------B-----------------------o-------------------o-----B------------------------------o--B-----B---------------o------------------------X----------o-----
----------------------------B------B--------B-------------------?-------X--------------------o------------------------------------B-----T-o------B--o-----E-------X-E-----Bo---o-E--------M-------o----B
-o-T----o---------------o-------------oo-----------------------T----M---Xo------M-------------------------oM-----------B-------MB-------|-----o---B-----------------------E--------X-----o-----------?--
o--|---B---------------B---------------------------E?-X--------|------E-------E--E-M-----------B-X---------X--------------o------o------|-----X----------------------------B------------o--------?------
o--|---o---------B--X-----------B------------E----o--o-E-B-----|----------------o------------------------------EB-o------?--B-----------|----------------------------------o--------o-B-o---------------
m--|--?------------B--o-----------B--Mo------Eo----------B-----|-B--o------------------------o----------o----------X--------------o-----|----o----E------o----B----------------------o-?-----------?----
XXX|XXXXXXXXXXXXXXXXX-XXXXXXXXXXXXXXXXXXXXXXXXXXXXXXXX-XXXXXXXX|XXXXXXXXXXXXX-XXXXXXXXXXXXXXXXXXXXXXXXXXXXXXXXXXXXXXXXXXXXXXXXXXXXXXXXXX|XXXX-XXXXXXXXXXXXXXXXXXXXXXXXXXXXXXXXXXXXXXXXX-XXXXXXXXXXXXXXXX
