---B-------o--------------?-----------?--B-o--------B----B---------------------B---------------------------o----------?--B-------B--------B----------o----B---?------B-o--------B--------------------B--
----o----------------------------------------------Bo----B-B--B------------------------------------B-----------------------------------B--o---B------------------------------------?-------o--B-----o---
o-M---B----------------M-B---------o-----------B------------------------------o----------B----------------------?----------------------------XX-B-------Bo---oo-----ooo--------------E---------------?--
-----------o-B------------o-----B------------o-----------X---------X--------------oX------------------------?o-?---------------------------------o---------------------E--------o-------?-------B-------
----?-------------------------X-----o----?-B------EB---------M-------X--------------------------------------------------o--------------------------------------------B------------------------o---------
--------o-B--o-B----B-------------o------------------?---------------------?--B--------------?---o--------------------------X---------B-o-----E-E----------B---?-----------------o--------------------B-
---o----o----------------------oB-----B------X------o--------------?---------------------------------?-o--B-------------o-----------------------------------X----------X--------------------------------
----?-----M-o-----B-------------------X----B---------B--------------oB-B------------------------------B-------------o----o----M--------------------X---------------------------------------------------v
--------------------------------------------------o----------X--------o---------M-----------------?--------------------------------B-o----------B---?---X---------------------B-----------B-------------
------------o------------E---------------------------------------------------------------------X--------------o--------------o-------o------------B------------------------?------o---------------------
--B-------------B----------o------------------------------------B--------------------M-----BX-------E---------------B---B----------M-------o----------?-----o--------B----------B-------------------BBBE
----?-------------------------------------------o---------B--------------------------B-------------------X--------?--o------X--------B-----------------?---o--------X-B--------M----------------EB----E-
------------o-o----o-B-BT----------------------------T--B----X-----------------------B-B--------o-M--------o--EE--o---------------o-----o-----------------------------------o----------------T-----B-E--
--??-----o--B--B----o---|-o--------------B-------o---|---------B---------------o------------B--M------------B---M-----?---------T------E--B------?B--o---E---o--------M-o-?----------------o-|----------
m----------------------B|---------------o----------------------------oo-B-------------EB-----|-----------------------------------o-----------------------?---------------X-------------------|----------
XXXXXXXXXXXXXXXXXXXXXXXX-XXXXXXXXXXXXX--XXXXXXXXXXXXX|XXXXBXXXXXXXXXXXXXXXXXXXXXXXXXXXXXXXXXXX?XXXXXXXXXXXXXXXXXXXXXXXXXXXXXXXXX|XXXXXX-XXXXXX-X|XXXXXXXXXXXXXXXXXXXXXX-XXXXXXX-XX|XXXXXXXXXXXXXX-XX-XXX
