---------------B---------o------------E--X----------------o-----------------o---------------------o-----------------------------------o------------------------------------o------?-o-----o-----------o-
--o--E------------------------o-------------X-------------B-----o------------------E----------M---o---M-------------------------B---------------------?------------?----B-------------------------------
--------X---o--------Eo-----B--------------------o----X---------------------B--------------------------o-B--------------o--------------------B-----X---o-----------o---------B--o--------------------o--
------------------B------X--------------------X-------------Eo----------?-----B--?-----------------------------------------------E--------M---------------------------?------B-o---o--------------------
------------E-----o------------------------o------------------------?--------------------------------M-----------------E------------------o------X------o---E--------------------------------------o----
----------------B---B-----------B-----?-------B----------------------------?---------------------B-----------o------------------------B--------------------------o--o-----------M-----------------------
---------------------?----E----------------o----?----?---------------------M----------------------o------------------------------------------o-----------o-----------B---oX-----------------------------
------------------------o--------------o-----?------o-----o---------?--B-------------------------o----------oo-B-o--------------------------------?--M---?-o-----E---B---X----M------X-----------------v
-------------------------------------?-----------M---B----B----Xo-----------------------------------------------B---------------------X------------?---------B----o----B----X------o------B-X---------o-
---------o----o-----oX----o--------o-------------------------o-E----------------------------?--------------B-o---------------------o--------------------------------o-------------------------?---X-----
---------------------------o-o---------------------------------M?---o------------------------------------------------------------------------B-----------------------E-------B----------o---------------
----Bo--------------------?-------Bo-----o----------B----------------o----------------------M-oX---------B-----o---B?--------?-------------------------------------o-------------------?----------------
-------E---------------------------------o------------o------------------------X---------o----------B-----Mo-------------------B------------------------B--------o--------o-B------M--------------------
------------------------E-------?-----------------T---------------------T-------------------------------------o--o---------------------------------------E-B-----------------------o--------------------
m--------------o----------------------------T-----|---------------------|-o------------------------------------------------------oBo-----o--------B-o-----------?------------------X-------X--B---------
XXXXXXXXX-XXXXXXXXXXXXXXXXXXXXXXXXXXXX-XX-XX|XXXXX|XXX-XXXXXXXXXXXXXXXXX|XXXXXXXXX-XXXXXXXXXX---XXXXXXXXXXXXXXXXXX-X-XXXXXXXXXXXXXXXXXX-X-XXXXXXXXXXXXXXXXXXXXXXXXXXXXXXXXXXXXXXXX-XXXXXXXXXXXXXXXXXX-XX
