----------?----------------o-B--B----------B---?-oB------------B--Bo-------o--B---o--------oo-----B--------------o-------------------BB--------B------------------------------------------------------T-
---------------------------?---------------------o------------------o------------------------------------------o--------B-----?------------------------------o-------o------------------------------o---
-----------E-?-------oB----------o--Bo--------------M----------oo-------B---------------------oB-----------o-?X-----------------B--------------------B--------BX-------------o------oo------------------
--------B-------------B-------B---?o-----o------------------?----X-M-B---------------------------------------------o------M--------------------B-M---------BB-----------------------------M-----------o-
------------------------------------o--B--o---------------------------o---------Bo---------------oB-?--?----?--o------B-----o--------M-----M---------B------------------?------B------------------------
-o?------------------------------E----o------?--------------?--------------o---------------------M-----------------B-----o----?-B----------------o--------------E--------B----------------E-B----------o
-------------------------------------B------B-----B---------------B------B-------------------------------------------M------------?---B-----------------M-oB------o--BB--------------B---------------M--
-----------------------?-----o-----B-?-o-X--------B--o-----------------------E-------M----B------------o-----?---------o--o----------------------------------M----E--X--------------------X-----Xo--o--v
----------?---------------X-----o----------X--X---B-o--------------o----------------------------B-?--------------B----Bo?----------------------------X-o-------o--------o-----------o-----B---------o---
-----------------------------B-o---------------B---M----------------M?------------o-----------B---------M---------------------------------------------------------o----------B-----------B--------------
---------------------------------------B---o--------------------B--?----------------E-----B---------------B---------------B-o-oB---------------o-------------B-------------B-------?-------T------------
--B------o---o----------------------------------------------Xo--B-B---B---o----E-------o-----------------------M-------BX----o---------M-o----T------------?---B---------------MB----------|------------
----?X----?---------------B------------------|-----|-----------B--M----------------------o-----------M---X--o------o-?--B--------M-----------------M----?-------o----B--o---B-X-XX--o----B-|--------o---
--o---B---------------o-o-----o------------B-|-----|--E--------------oB---------o---------------B----------------E--------?---------------------------------------------|o-?------------o--|-o---------?
m---E------------------?-----M----B--?-----B-|-B---|--------------?B----------------M-----------------------------o?--------------------B-------M------BM-------o----------------?-----o---|------------
XXXXX-XXXXXXXXXXXXXXXXXX-XXXXXXXXXXXXXXXXXXXB|XXXXX|XXXXXXXMXXBXXXXXXXXXXXXXXXXXXXXXXXXXXX-XXXXXX-XXXXXX-XXXXXXXXXXX-XXXXXXXXXXXXXXXXXXXX-XXX-XXXXXXXX-XXXX-XXXXXXXXXXXXXXX-XXXXXXXXXXXXXXX-XXXXXX-XXXXX
