------------B------------------E-------------------------------B------------B------------------------o------------o-----o--B-----------------------------oM--o----------------------X-------------------
---------o---------Mo-B-----?------?------------------------------------------o-------?------------------o---------------o----------o---------------?-----------------------B-----------?----o----------
--------BM--o--------------------MB-----?---B--------------M-------B-B---------o------B-------B--------------o----------B----B--------o-------E---------o-?------B---o------------------------------o-o-
oB-------------------------------------------X----------oo---o-------B--------------------------?M----Xo---E------X-B---------o-----?-----o--------------------------------?------------B?-------o------
-------------------?-------?---B------------B--------E---------------------------------------?---B------B-----o--------------------o-----------o-----B--------------------------B-----------------------
---o--E---------------------B--------------------o---B--------------------M-o------B-----------o-----MX-----B-M---B-B------------o----X------?-------oX---o-o------------o-----o-B---------o------------
--o---------B--M?------------------------o-------o---BBB--------------------------------------o-------------------------------B------o--------------------------B-------------o-B------E----------------
---------?-M--o---------------B-----B-----------------B------------E----------------X-------E---------------------------?B--X---E--------------B---B--------?--B---------X--------------M--------------v
-------------------o--------------------------E----o----o----------------------o-------------X----------o------M-------------------------------B---X--------o-B----------------------------------X------
o---o-------------------B------------?----------o------M----------------o--B---------------o------------o-o-----------------------------------B-------------------------o--M----------------------------
--------------------------o--------------------o------B--B-------B-B----------------------o--B---B--BB?--B----------B-----------B------B-----------------B---------M----------T------E----------B-------
--------o------------o-----o-----o-----------------------B-----oo---------B---?E----------------------------T----------M----o---------------M---------X---------?-------------|-------------------------
--------------o--B----------------B---------------------M-B------------------BX---?--------------B-E--------|--X---M-----------------------?-----B-o------------o--M----E---o-|---------------------?---
----B----------B---------E---------?--------------------------B--o---BB-|---------------X----------------o--|---------o--B---B-------------------------------o-B-----------B--|----o----o-----M---------
m-oM------------B----------------------------o-----------o-o----------B-|--------------------M-Xo-----o------?E------------?------------------B---o--o----------------BT------|--B-------o----o---------
XXXXXXXXX-XXXXXXXXXXXXXXXXXXXXXXX-XXXXXXXXXXXXXBXXXXXXXXXXXXXXXXXXXXX-XX|XXXXXXXXXXXBXXXXXXXXXXXXXXXXXXXX-BXXXXXXXXXXXMXXXXX-XXXXXXXXXXXX-XXXXXXXXXXXBXXXXXXXXX|XXXXBXXXXXX|XXXXXXXXXXXXXXXXXXXXXXXXXXXX
