T-------oM--------M---T-----X--o-X---B-----------------------------B----E---------B------o--o?---M--------------------?--------------B-----M--X----B-E-------B-------B-----------B---------BE------E----
------------Xo----------------B-----?--------------------T?------|---------B?---------------------B-------------E---B----------X-----X----------X--------------------------------------o--B------o------
-B--M-----T------o----B------------M----------|--M----X---X-------M-----------------------------------?-------o----B-----?-B---------B------X-o?----B--------o---------------BB-------------E-----------
--?---B---|----EM-----B--B--o------------B---------------|---B---|-|------------o--------?-----------------BM--------------X------X---------XEo---E-------------X------------------?--?-----------?-B---
-E----MB--|-------X---------------o--------B--------X--B---E---B--------M-------T-----BB-----B-X---B--------?-------B------------o--E---E--B-?-?-------|---B--E------?------X---Bo--B---X-X-----------o-
---------X|----X-----------|---------BB-----B-|--------------X-B--B-------------|T--------X---B------M------------X-----------T--X--T--------B---------|------------E-----o--??-------------------X-----
---B-E----|--------B----B---oB-?---------------E--------?|B--?--B|-|--------------B---------ET----B-o-----o---B---X-------|-?-o----|------B----------|-----E?-------------B----------------MX----X------
-------o?-|----oX-------M-T--?--X-------------E--T-------|----X--||---BE-----E---------o--?E-??---------|--M-------------B---TE-----------------------------?--X--T--o-------------------------?-----o-v
----------|-B--o----------|-------E--------X--|-E-----------E--o--------------T-||---------T----B-----B--M----B--M----------B-|-----|---|-----M-----M-T|B----BBB----B----?BB-T-----?----------------T---
--------E-|E----o---------|--------M----------|--|-o----B|-------|-|--M--------B-------T-----|--------------------B-------|---B--B-|-----T----?B-----|--B------|-|-------|B------------B-B-------o--|---
-----B-B--|-----------|o|-B|-------?----------|o-E-------T----------M-------o-|-||--------o|-------------E-----?----o---XB----|-----|X--|--?----------||-------M-----B-----------E--------------E---|---
--o-------|--MB-----------|----------B--------|--|---T--B|-------|-|?-BB---B---------o-|---X-|?E-B--B---------B-----oE------M----------------------?----?---E-----|--|X------o---------------o----E-|--T
---?------|-MB---E------EB|-B-BX-------X------|o-|---|-B?|X------|-|---B---------------|----?|-----------------o-------------|--------------------X------E----E---|-X|---M----E--o-E?o--------------|---
-----T-?o---------------E-|-B-------B---------|--|M-X|---|B------|-|-----E------X--?---|---B-|----oEB----B--------------?E|------X-|?B---o-----------------------X|--|-EE--------B------------------|--B
m-?--|----|-----X------T--|-----M--E-------T--|--|---|-o-|-------|M|----?-------B-----M----|--|---------E----E-B------|------|------BEo------XE---o---M--?-E------|--|---------E--EE---------BX-----|---
XXXXX|XXXX|XXXXXXXXXXX|X|XX|XX|XXXXXXXXXXXXXXX|XXXXXXXX|X|XXXXXXXXXXXXXXXXXXXX|X||XXXXXXXXX-XX|XXXXXXXXXXXXXXXXX-XXXXX|XXXXXXX|XXXXX|XXX|XXXXXXXXXXXXXXXXXXXXXXXXX|XX|XXXXXXXXXXXXXXXXXXXXXXXXXXXXXX|XXX
