---o---Bo-X----------------B--------o---------X--------o--------o-------B--o-------------o------o-------------------o--------------------o-----------------oo---o---------------B--------------E--B---E-
TE----o-------X----------?---o-------------------X--------------------------------------X----------------o--------------------o------------------o-----o-------o---------o----------------------------B-
M-------------------------------o-------B--o-------o-------o---o------------o---B------------o--------------o------o-oB------------B--B-B-----------------------------B----B---M-B---------X-----o-----o
-----o-----------X-oE----E--o-o--------------B--------B--------o------------------------------o----------B---o-----------o--------------------BB--o----B---o---------o--o--------o----------X-----------
-----------o-----------o--------B---o-----o-------------------------------B------o---o----o----?-B--------oM---------------------o-----------E-------------------------------o---?--o-------------------
-o------B-----------B-o----------o-----o-----------?-EX------------B-------------------------------------o-------------------?----o----------------B----------------------------------------------------
-------Bo---EB---------o----o----o-----B-o---?-------B----o--o---B-------M---o----o---o-Mo-----------o---------o-----B----------B----------------------B---E-----o-BB-----------------------------------
-----oo--------------X----------------------B----------------------------------o---------o-------------B---------?----E-----B-----------o------------E------X-------o-o------M--------------B----B--Bo-v
----B-----------------------o-------------------o-----------o---------o------------------------ME------------------------o---------B----o------------------------B------------B------B-------------B--o-
-----B---------o--o------o-?----?---B--------M-Bo--o-----------o---------------X----E-----------------B-----o-------------------E-----o----B-----------B---------------o------o--------------B-E---B--X-
--------------------o--------------------X------------------------------o---B----o-------o-Eo-------------------X----------E----------?EX-M-o----B------o---------------o------------o---o--------------
---------?--------------------------------T-----oB---------------?--T-o----B-----------o-------------------------o-------E----o?------B---------o--------------------X--------E---------Bo-E---B----o---
---oo--------o--------o-------------------|-------?---T-B-----------|--------B------------------M------------------oB--------------------B----o-X---------E---------o--------o-B----E-o--B--------------
--------------------o----oT---B----------------Xo-------B---------B-------------T--o----------------------------------------B?--------------o------?----M------------------X--E----------------B------B-
mB--------T-----o-?-----------B-----?-----|--------o--|-------------|----------o|---o---------------o----?----------o---M--T--B---B--------------o--B----o--TB-o-------M-----?--------------------o-----
XXXXXX-XXX|X-XXXXXXXXXXXXXXXXXXXXXXXXXXXXX|XXX-XX-XX-X|XXXXXXXXX-XXX|XXXXXXXXXXX|XXXXXX-XXXXXXX-XXXXXXXXXXXXXXXXXXXXXXXXX-XXX-XXXXXXXXXXXXXXXXX|XXXXXXXXXXXXXXXXXXXX|XXXXXXXXXX-XXXXX|XXXXX|XXXX|XXXX-XX
