-o-----------------------------------o------E------------X------M----B------------------------o-------------------E---------------B-------o-----o--o-------------?--------oB---------X------------------
---B-------------o---------B---------Bo-------------------------------B-------------------------E---o-------o---------o-------o----------X-----------------------o--------------------------------------
-----------------B-----------E-------------------o----------------------E---------------------------------------------------------------------------------------------B---------o--------o------B-------
------B---E-------B---o-----------------------o-------------------?--------------------------Xo-------o----------------E--------------------------------o-X------------------------o-----B--------------
------o------------B-----------------------------------X--------------------------------------o-B--------o-----------------------X--------------X--------------------------M---------------oB--B--------
-E---o----------B-------------------B--M----------------?----------------------o--o-X----o--------------B-------------------------B--B----------------?-----B-------------------------------------------
---------------------------------------X-?---X---o-----M-----o---------------o--------------o--------------------------------------------------B----------------??-----------------------B--------------
B--------------------------------X--o--------B----X-----------B---------?------------------------------------X-------------------o-----------------------?-----------E---------------------------------v
-------------B----o----o--------o----------oE--------M-------------------------------?---------------------XM----------------------------------B--------------------------------------------------------
------------------------B--------------------------------------------o--?------------?--o--E-----------------------------------------------X------------X-------------------------?-E----------------X-o
------------------o----B-----o-----M-----------------------------------------TT----------------------o--B-----o----------------?-------B----------X----E---M----------------o------------B-----------B--
X---------B----------o---X--------------o---o------BoB--o-----------o-----o----------------o----T--TX------------o--------------E-----o---------E------------------oB-----------------------------------
-------------------------X--M----------------------o--------------------------------o--T------------------T-o--------?--------oo---B--BE--o-----------------------------------B--------------B----------
--------X------------M-----------?------------o------------------------------||----?---------o------------|o-----------------------o-----------o---------------------------B----------------------------
m----E----------------T------------E--------X-------|------T--B---------o----||-X-------oB------X---------|---------------------------------------oBoT----------------------------o-------------------o-
XXXXXXX-XXXXXXXXXXXXXX-XXXXXXX-XXXXXXXXXXXXX-XXXXXXXXXXXXXXXX-XX-XXXXXXXXXXXXXXXXXXXXXX|XXXXXXXX|XX|XXXXXXXXXXXXXXXXX-XXXXX-XX-XXXXXXXXXXX-XX-XXXXXXXXXXXXXXXXXXXXXXXXXXXXXXXXXXX-XXXXoXXX-XXXXXXXXX-XXX
