-------------------------------------------------------------------------------------------------------------------------------------------------------------------XXXXXX-------------------------------
--------------------------------------------------------------------------------------------------------------------------------------------------------------------------------------------------------
--------------------------------------------------------------------------------------------------------------------------------------------------------------------------------------------------------
--------------------------------------------------------------------------------------------------------------------------------------------------------------------------------------------------------
-----o-----------------------------------------------------------------------------------------------------------------------------------------------o--B-----------------------------------------------
-------------------------------------------------------------------------------------------------------------------------------------------------------------------------------------B------------------
--------------------------------------------------------------------------------------------------------------------------------------------------------------------------------------------------------
-------------------------------------------------------------------------------------------------------------------------------------------------------------------------------------------------------v
---------------------------------------------------------------------------------------------------------------------------------------------------X---------------------------------------------------f
--------------------------------------------------------------------------------------------------------------------------------------------------XX---------------------------------------------------f
-------------------------------------------------------------------------------------------------------------------------------------------------XXX---------------------------------------------------f
------------------------------------------------------------------------------------------------------------------------------------------------XXXX---------------------------------------------------f
-----------------------------------------------------------------------------------------------------------------------------------------------XXXXX-------o------------------------------o------------f
----------------------------------------------------------------------------------------------------------------------------------------------XXXXXX-------------------------M-------------------------f
m---------------------------------------------------------------------------------------------------------B----------------------------------XXXXXXXE---------------M---E------------X-----------------X
XXXXXXXX--XXXXXXXXXXXXXXXXXXXXXXXXXXXXXXXXXXXXXXXXXXXXXXXXXXXXXXXXXXXXXXXXXXXXXXXXXXXXXXXXXXXXXXXXXXXXXXXXXXXXXXXXXXXXXXXXXXXXXXXXXXXXXXXXXXXXXXXXXXXX-XXXXXXXXXXXXXXXXXXXXXXXXXXXXXXXXXXXXXXXXXXXXXXXXX
