----------------------------------------------------------------------------------------------------------------------------------------------------------------------------------------o---------------
-----------------------------------------------------------------------------------------?--------------------------------------------------------------------------------------------------------------
----------------------------------------------------------------------------------------------------------------------M---------------------------------------------------------------------------------
----------------------------------------X---------------------------------------------------------------------------------------------?????-------------------------------------------------------------
----------------------------T------------------------------------------------------------------------------------------------------------------BBBB-----------------------------------------------------
----------------------------|----------------------------------------------------------------------------------------------------------------------------------------------------------------T----------
---------------X----X-------|-----------------------B--------------------------------------------BBBBBBB----------------------B---------M----------------------------------------------------|----------
---------o---------XX-----BB|BBBB------------------------------------------------------------------------------------------------------------------------------------------------------------|---------v
------------------XXX---T---|-----------------------------------------------????-------------------------------------------------------------------------------------------------------------|---------f
-----------------XXXX---|---|-------------------------------------------------------------B---------------------------------------------------------------------------------------????????---|---------f
------------o---XXXXX---|---|---------------------------------------------------------------------------------X-----------------------?----------------------?-------------------------------|---------f
---------------XXXXXX---|---|--------------M-----------------------------------o-----------------------------XX---------------------X--------------------------------------------------------|---------f
--------------XXXXXXX---|---|-------------------------------------------------------------------------------XXX----------?????--------------------------T----BBBBB------------------------X--|---o-----f
-------------XXXXXXXX---|---|----------------------------------T-------------------------------------------XXXX-BBBB---------------------BBBBBBBB-------|------------??????-????---------XX--|-----T---f
m-----------XXXXXXXXX---|---|--------------------------------E-|-----------------------------------------EXXXXX------------------------E--------E-------|-----------EE------------------XXX--|-----|---X
XXXXXXXXXXXXXXXXXXXXXXXX|XXX|XXXXXXXXXXXXXXXXXXXXXXXXXXXXXXXXXX|XXXXXXXXXXXXXXXXXXXXXXXXXXXXXXXX--------XXXXXXXXXXXXXXXXXXXXXXXXXXXXXXXXXXXXXXXXXXXXXXXX|XXXXXXXXXXXXXXXXXXXXXXXXXXXXXXXXXX-X|XXXXX|XXXX
