-----------------E--------o-------------M-----------------------------------------------------------o----B--------B---o-o------?----------------------------------B-----o-------------------------------
-------B---------------B-----------o------B------------------o--------------------B--E-------M--------o------o----o---B------X-------------o----E----------------o-------o---------o-------------E-oE---
----o------M---o-----?---oB---------------------------------------o---o--------?-E--X-----o---------E-------o--o--------------B-------BX----------------------------------?---X--------E----------------
--------------------------o---------------------B-------o---o------------?--------o---------------o--------------B----------------------------------o---E----o--------------------o----o-------o--------
------oM------------------------E-------o------------?-o-----------o--------E-?o---------------B----B-----o-----B----X-----------E-------?-----oX-----------------------------o----------o------X----o--
-------o--------------------X-------------------------o-----------?--X----------o----------o-----------X-B---------o----------------------------B--o--------------?o------------------------------X-----
-o----------B--------------B--o---------X---B----oB---oX--------------------o---------o-X-------------B------o----------------X---o-B-------oE--o--------B-------------M------B------------?-------o----
------MB---------------------------------------------o?--B----o--------oX------?-E------oo-------------------o---------X-----B---------------------------------oo-----------M-B-----B------------------v
------------o------B---X------------o----------------BB-----E---------------o--EB-----o-------------------E----------------------B-M--?------B-o-----------B-----------------?----------------M-------o-
----o--------o--------E----X----------------o-------------------------------B------------------------------------oX----------o---------------o--o------o------------------------------------------------
----E-------------------B----------oM------------------------B----o--------------------------------------o--o?--------E--------------o-----------------M---------B------o------o--o---B------BB---E--o--
o-----------------??--oT-E----B--------B-----M-------E------------E---------------------E?------------B--------o------?---------------X------B------B------oo--o---------B-------------------o----------
------------X---oo-----|-B--------------?---------------------M---------o--o-B-o-----?-X----o-------------o--o----E--E----------------E------------------o--B-----------o------E----------?-----X-------
-o----B------------B---|-----------o----------------B-------BX--------------------B-------X---T---E---M-----o----o-----B-----o----------------------B----B---To----o--o---E--------B--------------------
mo-------------B-------|----------M----o---------E-----------------o-----B-?-B---o------------|?----------------------------?-----oE-------------------------|----o-------------------E---------B---X---
XXXXXXXXXXXXXXX-XXXXXXX|XXXXXXXXXXXXXXXX-XXXXXXXXXXXXXXXXXXXXXXXXXXXXXXXXXXX-XXXXXXXX-XXXXXXXX|XXXX-XX-XXXXXXXXXXXXXXXXXXXXXXXXXX-X-XXXXXXX-XXXXXXXXXXXXXXXXX|XXXXXXXXXXXXXXXXX-XXXXXXXXXXXXXXXXXXXXXX-X
