T------------------------------E--o----B--XBE-----------------------?---E---------B------o-------M--------------------?--------------B-----M--X----B-E-------B-------B-----------B---------B-------E----
------------Xo----------------B-----?--------------------T?------|-T-----X---------B-------B----XB------------------XB--------X-----?-?E-B-----------T----?--B------B------------------o--B------oE-----
-B--M-----T------o----B--------E----------------------?--|---?---|-|-?--------B----B---B---------------?--------------------B---M--T----B------------|-B--X------------------BB--------------B----------
--?---B---|----EM-----B--B--o------------B--------M----------------------M---X------------B----------------BM----B---------X--B---X---------XEo---E-------------X------------------?--?-----------?-B---
-E--X----------?--B-----------|----B---o?--T-----BX--|-------------------------o---E---------------Eo---T---B-------X-------------------------------------X------------------?------E----B------------o-
---------X|----X-----------?E------------o--------------E|-----B-|-|--B--X-------------?-------B------E-----------X-------T-B-----E|-B----X-B---M----|--------E-X---------o--B--------B-----------X-----
---B-E----|--------B----B---oB-?---------------E--------?|B--?--B?E---X-B-------||---------------E----------------------o-------X--------------------------E?-------------B----------------MX----X------
-------o?-|----oX-------M-T--?--X-------------E--T-------|----X----|------------B------------|-----?--B---------------o---M---|B----|--B|-----E------?-|--------------o------------------------?---B-o-v
----------|-B---Bo-E--|-|--|--X---E--------X--|-E-----------E--o--------------T-||---------T----B-----B--M----B--M----------B-|-----|---|E----B-----M-T|B----BBB----BX---?--B---|-----B-------------T---
--------E-|E----o---------|--------M----------|------|------------|--M--o-B--------------B--------B---o-|B---------------E---|------o---------------------o-------|--T----B-BB---------B-B-------o--|---
-----B-B--|B----E---------|----B--------------|B-----|---------B--|--X--E---------------BB--X---------B-|---------X--------X-|B------------B----------------------|--|-----------E--------------E---|---
--o-------|--MB-----------|----------B--------|--|---T--B|-------|-|?-BB---B---------o-|---X-|?E-B--B---------B--o------X---M-|-?---|--M|-------------||---------?----X------o---------------o----E-|--T
---?------|--B---E------EB|-B-BX-------X-----E|----------|-----------------?--|-||B--------|-B|-M-----B---------------T-------|-----|---|?X-----?---B-||------------M|-B-M----E--o-E?o--------------|---
-----T-?o-|-------------E-|-B-------B---------|--|M-X|---|----B-------------B-|-||------BB-|--|----------------?------------M|--------B--------------------------X|--|-EE--------B------------------|--B
m-?--|----|----------X|-|--|--|B--X--B--E--|X--------|-M--------|-|---|----------------B-----E-----T---o|-B----------|-------|------BEo------XE---o---M--?-E------|--|---------E--EE---------BX-----|---
XXXXXX|XX-|XXXXXXXXXXX|X|XX|XX|XXXXXXXXXXXXXXX|XXXXXXXX|X|XXXXXXXXXXXXXXXXXXXX|X||XXXXXXXXX|XX|XXXXXXXXXXXXXXXXXXXXXXX|XX-XXXX|XXXXX|XBX|XXXXXXXXXXXXX||XXXXXXXXXX|XX|XXXXXXXXXXXXXXXXXXXXXXXXXXXX-X|XXX
