-?-------------------------------------B---------------------------o----o----------------?---------o-o---X-----X?--M-------X--BB----------------------X-------E------B-----?-------------?o-----------E-
------------------o--------------------o----?--------o----------o-----M--------------------------E----------------------------E-------------------------------------------------------------------o-----
-----o--o-----------------------------------------------------------------------------o-----B----------------------------------o--E---o-B-----------------------------o-----------------------o---------
--------------------------E------------------------------------M-X---------------------------o--E----------------------------------------------o-----------------E--------o----------o---B--------------
-------------o--------------------------M------------o----------B-B--E----E-----o--------------------------o----------o----------------------------------------B-------------------X----oo---o----------
------?------B----------o------------o--o---------------X-----------------------------------------B---B---?-----------------B------------------------M----------B---------------------------------------
-------B----------------------o----B-------------B-----o-o-o-----------------------------------------------?--B---------o---------------------B------------------------------------------?--------------
-----------------------o--------o-------------------------------------?------------------------------------------------------------------B---?-------B-E---M-?---------------------E----------------o--v
-----------------------------------B--------X--------------------------------B---------B-------------------B------------------------------------------------o---B--------------------------------------E
--E---------------------?------------------------------------------B--o--------BB--E--------------o----Xo-o---------------------X-o---------------------------------------o---B---------E-o-------------
------o--------------T--o-----------------------------------X------------------B-----------M----?---------------------------------------o-------------B-----------------------E-o-----M--?------o-------
---?--M----------------------X-----------------------o-----BE---------------------------------------------------o-o-------------B-o----o---B------------------------E--------------X-o---B-----oM------X
--------------?-----o----------------------E---------------o--------------------------?--?----o-----------------------------o--------------------------o--o-------?---o-o------o------------------o-----
-----------------B-----o----M----------------o-------?---------------B---------o------------B--X----------------B------------B--B-----o------E-o---------------------B---E----o-------------------?-X---
m-E--------------X----B--------M-|--------T-------------------------------------o-----------------------|--------------------------o-----------------o----------|-?---------------------------------B---
XXXXXXXXXXX-XXXXXXXXXXXXX-XXXXXX-XXX-XXXX-XXXXX|X--XXXXXXXXX-XXXX-XXXXXXX-XXXXXXXXXXXXXXXXX-XXXX-XXXXX-X-XXXXXXXXX-XXX-XXX--XXXXXXXXXXXXXX-X---XXXXXXXXX-X-XXXXXX|X-X-XXXXXXXXXXXXXXXXXXXXXXX|XXXXX-XX-X
