------------------------------------------------------------XXXXXXX-------------------M------------------o----------------------------------------------------------X-----------------------------------
----------M-----------------------XXXXXX----------------------------------------------------------------------?-------o---------------------------------------------------------------------------------
----------------------------------------------------------------X---------------------------------X-------------------------------------------------------------?---------------------------------------
---------------------------------------------------------------------------------------------XXXX???????-----B-----------------------------------o---------------------------o-----------------X--------
-------------------------X-----o-----------B-----------------------------------------------------------------------------------------------------B-M-----------------------------????-------------------
--------------------------------------X-----------------------------------------------------------------------------------------------------------------------------------------------------------------
-------------------------------------XX--------------------------------------???????B---------------------X-------------XB---------------??--------------?----------------------------------------------
---------------------------o--------XXX------------------------------------------------o-----------------XX-------------------------?------------------------------------------o-----------------------v
-------T-----------T---------------XXXX------------------------XXXXXXXX---------------------------------XXX--------------------X-----------------------------------------------------------------------f
-------|-----------|--------------XXXXX----------o-----------------------------------------------------XXXX----------B--------XX-------T----------------------------------T----------------------------f
-------|-----------|o------------XXXXXX---XXX---------------------------------------------------------XXXXX------------------XXX-------|------------------?????-----------|----------------------------f
-------|---------B-|--X---------XXXXXXX-------------------------------------------------M---T--------XXXXXX-----------------XXXX-------|-------------------------------BB-|----------------------------f
-----?-|-----------|--XX-------XXXXXXXX---------------------XX-------------T----------------|-------XXXXXXX----------------XXXXX-------|----------------------------X-----|----------------------------f
-------|-----------|--XXX-----XXXXXXXXX------------------------------------|----------------|------XXXXXXXX-----TT--------XXXXXX---X---|M---------------------------XX----|----------------------------f
m------|-----------|--XXXX-E-XXXXXXXXXX--------------E---------------------|-E--------------|-----XXXXXXXXX--E--||???E???XXXXXXX-------|----E-----------------------XXX--E|-E-------------------------oX
XXXXXXX|XXXXXXXXXXX|XXXXXXX-XXXXXXXXXXXXXXXX---X---XXXXXXXXXXXXXXXXXXXXX---|----XXXXX-----XX|XX-XXXXXXXXXXXX----||XX--XXXXXXXXXXXXXXXX-|BXXXXXXXXXXXXXXXXXXXXXXXXXX?XXXX--|----------XXXXXXXX----------X
