-X-----------o--B-----------------------oM-oX-------o----o------------------o---X----o----------------o--------B--o-----B--------B-----------o--------------------oB--------------X-o---o-----B---------
-oB----o-----B-----o-o------------------------X--?---?----------------B----E------------o-----------------oB-------------------E-----oo--BB------------M-------------------------------?------o---------
--------?----o--E-o---------------o------------------------o-----------------?--------------o-----------?--------------------B----------B------------B-----o----------------------?----?---------------o
-o----o-------o------------------------------o--------------?M--------------?-o----------------------o---B----------E-------X------?---------------oE---------------------------------------M------B----
--BB--o---B----o-----------o------------------------------B-----o--------------------------------B------X-B---------------B-------o---B------o-----------------------------B--------------------o----E-E
--------oo-o-------B---o-o--X-----B-o--?-B---o----------o--------o---B--------BM-----------B----B--------M-----------B------B------------E----------o-?--o---------------BB----------o--------------B---
--o-----------o-----------B----M--------B------------------------------------------B-B----------------E--B----------------B-----E------------B-----B-----B-----------------------?------------B---------
-------?-o-----------o------o---?------B--------B-----B----o------o-o-------B--------------------o-B-------X---------?--M---o---o-B-------?----o---------B--o---B-o-----------------------------Bo-----v
-----------------------o-o-------o---o----------E----------o--------o----------------?-o-------X-B--------------o-------------?----B--B-------o---------------o--------o-----o----BB---o---------o---X--
----o--X------------?-----o--o-----------B-X-----------------o-----------------E----------o-E---o----------E---------------------o--o-E-----------o-o-?-o----------o--------o-----------EX--------------
-----o----B--o---B-------------------------------------------------o-o-------E----B------------B------B----o------------------------------o-------------o-B-o------------------------------M------------
----B-----o-T--B----------o----------E---o---B---------?B------o-B---o-?-----------------------TB-----------------------o--?----o-----B------E----B--------------X-B---------------X--------------?-----
----o-o-----|-----------------------T----------B--T-B--------oB---Bo--B---E----------------T---|-------------BMX-----o-?--------------B---------------------?--B------o---------B-----E----B--o---------
---T--------|--X----------o---------|-------------|X-o-----------o-----------------B------o|-o-|--------?o---o---BB---B----B----------------------o----------B---------o----B-----o---------o----B------
m-B|--------|-------------------o--B|---EooB------|---------------o----E-------------------|---|-----T----?o-T------------------B-o----------B------o-------------T--o---o----------------M--X----------
XXX|XXXXXXXX|XXXXX-X-XXXXXXXXXXXXXXX|XXXXXXXXXXXXX|-XXXXXXXXXXXX-XXXXXXXXXXXXXXXXXXXXXXXXXX|XXX|XXXXX|XXXXXXX|XXXXXXXXXXXXXXXXXXXXXXXXXXXXXXXXXXXXXXXXXXXXXXXXXXXX|XXXXXXXXXXXXXXXXXXXXXXXX-XXX-X-XXX-XX
