------------------------------------------------------------XXXXXXX-------------------M------------------o----------------------------------------------------------X-----------------------------------
----------M-----------------------XXXXXX----------------------------------------------------------------------------------------------------------------------------------------------------------------
----------------------------------------------------------------X-------------------------------------o---------------------------------------------------------?---------------------------------------
---------------------------------------------------------------------------------------------XXXX???????-----B---------------o-------------------o---------------------------------------------X--------
-------------------------X-----o-----------B------------------------o----------------------------------------------------------------------------B-M-----------------------------????-------------------
--------------------------------------X-----------------------------------------------------------------------------------------------------------BBB---------------------------------------------------
-------------------------------------XX--------------------------------------????????-----------------------------------X----------------??--------------?----------------------------------------------
---------------------------o--------XXX-------------------------X----------------------o---------------------------------------------------------------------------------------o-----------------------v
-------T-----------T---------------XXXX------------------------XXXXXXXX--------------------------------------------------------X----------------------------------o------------------------------------f
-------|-----------|--------------XXXXX----------o-----------------------o-------------------------------------------B--------XX-------T----------------------------------T----------------------------f
-------|-----------|o------------XXXXXX---XXX-------------------------------------------------------------X------------------XXX-------|------------------?????-----------|----------------------------f
-------|---------B-|--X---------XXXXXXX----------BB-------------------T---------------------T-----------------------o-------XXXX-------|----------------------------------|----------------------------f
-----?-|-----------|--XX-------XXXXXXXX---------------------XX--------|--------------------M|------------------BBBBBBBB----XXXXX-------|----------------------------X-----|----------------------------f
-------|-----------|--XXX-----XXXXXXXXX-------------------------------|-----------T---------|-------------------T---------XXXXXX---X---|M---------------------------XX----|----------------------------f
m------|-----------|--XXXX-E-XXXXXXXXXX------------E-E----------------|-----------|-------E-|E----E----------E--|-???E???XXXXXXX-------|----E-----------------------XXX--E|---------------------------oX
XXXXXXX|XXXXXXXXXXX|XXXXXXX-XXXXXXXXXXXXXXXX---X---XXXXXXXXXXXXXXXXXXX|X--------XX|XX-----XX|XXXXXXXXXXXXXXX----|XXX--XXXXXXXXXXXXXXXX-|BXXXXXXXXXXXXXXX--------XXX?XXXX--|----XXXXXXXXXXXXXX----------X
