---------------o--Bo------------------------o-----------o--------------------------X------o-----?---o--------o-----------?-------o----------------------------------o----------------------------------o
----B-----------------o------E---o-------o-o---B---------------o---B--o-----B-------------o----------E----B----o----------------------------------------o--------E-----------------M--o-B---------------
------------E--------M------------------X------o---------B---B-------------------o-----X--o-----------------o------------------o-?B---------o-----------------o---------------X-------------------o-o--o
o----------E---------------------E-----------oE-----------------BX---------------------------------??-X-----------------------------o----o--------------------------------------------------------------
-o------E------o---------o---E-----B----Mo------X---M-----o-------o-o-----?-oB-------------o------------o----------E---o---------------------------------------o------------o-B-------------------------
----o------------------------------------------------?------------B--------------B-----o---o--------o---M----B----------------B-----------------------------o--o-?--o-------o---o-------o---------------
---------------------------B-----------X-------------------------o----------o----------o-----o-----o-----o-B-----E----------------------o-------------M---o-----?-------B-o--------E-?-?o---------------
-------------------B----M-----------o------------------oM--------o-------B-----------?-----X---------o-E----B-------B------------------o-----o----------------------E----o--o-------o---o------BoX-----v
-o------------------o--o--------------o---X--o--B-----ooX----------------------o-M-M---o----o--------------B---------?-------------M---M-----oB--------Bo-----X---------------B------------o------------
---M------------B-------------------o---o---B-o----------o---------B----o---------o--B--------X----------o--o------B--------------B----o-------------------o--------------------o-B----o---B----B-------
--------B-B-----B--------------------------o---T---------BB-----------------------------------------------X----------------M--B-------------------o---B---o----------------T-X------------M-------------
----ooE-------------------------o-M-o----------|------M---------------T--o--------E-----M---------------------------M------------o--------o-----------o--Bo----------------|------------T-------------?-
-------------E---E-------?---------B-----M-B-o-|---------------B-B----|-oo-------------o---o--B-----------B------------?--------------------B------------X--o--B?----------|------------|--o------o---X-
-----M---------o---Bo----------o---------------|----------------------|--?-----X---------o----------o--------------o---------?o------------o------------o-o----------------|--o--------o|-B-------------
m--o----o----------------------------o---------|------o---------------|-----o---X-------E-B---------------o?-------------------------o--T---?--------B-o----o------B--E----|------------|------M--------
XXXXXXXXXX-XXXXXXXXXXXXXXXXXXXXXXXXXXXXXXXXXXX--XXXXX-XXXXXXXXXXXXXXXX-XXXXXXXXXXXXXXXXXXXXXXX-XXXXXXXXXXXXXXX-XXXXXXX-XXXXXXXXXXXXXXXXX|XXXXXXXXXXX-XXXXXXXXXXXXXXXXXXXXXX|-X-XXXXXXXXX|XXXXXXXXXXXX-XX
