---------------------------------------------------o-o-------------X---B--------------------o-----oo----B-----o----oB------o--E---------o----o----?---B-o-------B-o--B--?--------------------o-------?--
------E----------------B-o--------oM----B-------?----------------------------------------o---------B-----o-------X-----B----o-----X----o----------X----------o-------------X--------o-B-----------------
------o-----E---------------------B----------------------B---o-----o--------------------------------o--M-------------X----?---o-----M-----------------------------o-----------------------------?--B----
---B----------o----------------------o------B------o-B----------------B-----o----------BB-------------E----E--------o-----------o-------------------X-o---------------E------------E--------------o----B
o---------------------------------------------o-------------?------------X----------------------------B?-------------------o---o-------------------------o----------B------------o---------o-------X----
--?---------------?--------------M------------------?------------M-------------------o-o-------------------------X------B---------------X----XX---------o----------o---------X--------------------------
--------------------------------E---B-----------B-----------------------o---------------------o-------------------------------M-------------------o----o-B-o-----B---------------E---B-o----------------
-----------------B---------?-------------------oo-----------------o-------------B-?---oX---?----XE-----B--B--E----o----------------------------o----------------------------------o--------?--o--------v
----------------ooo-o--X---o-------------?--------o-----E----oXo----------------------------oBB-------------------------X----------?--------?---------X--o-------o--------o---Bo------B-----------B--o--
-B----B-----B------o----B-Bo------------------------B-----------------M----B------B--------o-B------X---B----?----B-------X-------------o----------o--o-------------?--o--------o-----------------------
o----------T-------oM-------------------------o-o---------?-o-------o-------o---o----------------------------------------------------------------E-------------------------------------------------T---o
------o----|----------------------EX-----------B-------------------?----o-------X-X-o-----------B----M----B--------X-----------o----------------------?--X--------B-B-T----ooo-oE----------B-------|----
-----------|----Mo--------------oB--B-E-----------------------------o----B----BT-------------oo-----------T----------------------o--M----------o----------------------|---o--B---------------------|----
------B-o--|--E---?---E-----------o-------------------------------B-X----------|--------oT-------------o--|----B------------------------------X---------o-------------|--------------------?-------|----
m--X-------|-------------------E-----?------------oo------E-o-------------B----|-Mo----T-|----------------|B-MoB----X--------?---?---------X--------E----------E-----E|------------------------oE--|B---
XXXXXXXXXXX|XXXXXXXXXXXXXXXXXXXXX-XXXXXXXXXXXXXXXX-XXXXXXXXXXXXXXXX-XXXXXXXXXXX|XXXXXXX|X|XXXXXXXXXXXXX-XX|XXXXXXXXXXXXXXXXXXXXXXXXX-XXXXXXXXXXXXXXXXXXXXXXXXXXXXXXXX-|XXXXXXXXXXXXXXXXXXXXXXXXX-XX|XXXX
