-?------------------------------------E----------o-------?-------B------------------------------o------E-------------------------B---------------------------B---------------o--------------?----------o
-------B-----E--------------------------o-----------------------M-B---o----?------------?------o----------------o--------------------------M----o--------M-B------o----------------B----o--------o------
--------------------------M-----------B--oB------------------------?-----o-----o---------X-----------BB----E---o---B----------------------------o---------------------B-o-----------------------E----?--
--------?X-o-----?-------M------B-------o----------------------B-----M------------------------------------------------------------o-------o----------------B-----X------------------------------o-------
---B---------B--------------------------------------------B------------o----------X-----------E-------B--------------B-----B-BB--o-B----B-B-----B------------o--?---------B-----------------------------
---------BM----o-----------------------E--?--o----------------------------B----o-----B--B-------------oo-----o------o------B---E---B----E---Mo-------------------------------?-----B------------B-------
------B-B--------------------B----------------o----B-----------o-----------------------------B------------B-o---------?--B----?----------?-----------------B----------B-----o-X-----o-------------o-----
--------------B---------------o----o-----------------o--------------------------------------X-----?-----B-----B--?o--?-------E----M----o-------?o-------------o---B---o------B----oo------------B------v
--------?-------B---------------B------------B--------------B-------o----B---o----------------------B---o-----o?---------------------?-------o-------------------------------M-o------------------------
--M---------E-------------------------------------o------B---------------B-----------o--------------------------------?----o------------------o---o----------o---o----B---------------------------------
----------o-------------------M---B---------------------o-EX-----------------------B-------M-------o--------------------------------------------------X?---o------------------B----------o---------X-o--
------M---------?-----------B-----o----M-----E-----------E---M-B-------------B--T--------|---o---o-----o---------------------------------o---B-E------------o--M------------------X---------------------
---o-------Eo--------------T------o--------------o------M------------------------X--------------------E--------o--------------------X--o-----------------M---------------------------o---oo------B-B---B
-------------------o-------|--------o---------------------B----------X-----oo---|--------|-----------------------------------------------------?-------------o--------------?-----------------------o---
m------X---------o--M----------B-o----E--o--------------------B---------------------o----------?------M-B-------------X--X-------o-----------M--------------------B------------B--------------B---------
XXX-XXXXXXXXXXXXXXXXXXXXXXX|XXXXXXXXXXXXXXXXXXXXXXXXXXX?XX--XXXXXXXXX-XXXXXXXXXX|XXXXXXXX|XXXX-XXXXXXXXXXXXXXXX-XXXXXXXXXX?XXXXXXXXXXXXXXXXXXXX-XXXXXXX|X-XX-XXXXXXXXXXXXXXXXXXXBXXXXXXXXXXX-BXBXXXXXXXX
