--------------------------------------------------------------------------------------------------------------------------------------------------------------------------------------------------------
------------------------------------------------------------------------------o--------------------------------------------------------------------------------------------o----------------------------
--------------------------------------------------------------------------o-----------------------------------------------------------------------------------------------------------------------------
------------------------------------------------------------------------------------------------------------------------------------------------------------------------------------------------BBBB----
-----------------------------------------------------------------------------------B--------------------------------------------------------------------------------------------------------------------
--------------------------------------------------------------------------------------------------------------------------------------------------------------------------------------------------------
--------------------------------------------------------------------------------------------------------------------------------------------------------------------------------------------------------
-------------------------------------------------------------------------------------------------------------------------------------------------------------------------------------------------------v
----------------------------------------------------------------------------------------------------------------------o--------------------------------------------------------------------------------f
---------------------------------------------------------------------------------------------------------------------------------------------------------------------------?---------------------------f
-------------------------------------------------------------------------------------------------------------------------------------------------------------------------------------------------------f
-------------------------------------------------------------------------------------------------------------------------------------------------------------------------------------------------------f
-------------------------------------------------------------------------------------------------------------------------------------------------------------------------------------------------------f
---------------------------------------------------------------------------------------------------------------------------B-------------------------------?---------X---------------------------------f
m------------------------------------------E----------------------E-XXXXXX----------------------------------------------------------------------------------------E--XX--X-----------------------------X
XXXXXXXXXXXXXXXXXXXXXXXXXXXXXXXXXXXXXXXXXXXXXXXXXXXXXXXXXXXXXXXXXXXXXXXXXXXXXXXXXXXXXXXXXXXXXXXXXXXXXXXXXXXXXXXXXXXXXXXXXXXXXXXXXXXXXXXXXXoXXXXXXXXXXXXXXXXXXXXXXXXXXXXXXXXXXXXXXXXBXXXXXXXXXXXXXXXXXXXX
