------------------------------------------------------------------??oo-M?M-X?-XM-BBoX-oBo?oMT------------------------------------------------------------------------------E?MEE|BT-|BT||MTM-?|?EoT-oBE-
-----------------------------------------------EMXoEM?M-M?ME|Mo?oMB--?BEB|E-EXEMoE|TXMMMT|XMXMTEBEo-----------------------------------?-M---|?-EB-?o-EMEEoB?Eo|E|E-|BBTX??T|-----------------EMTEMX??-T-
-----------------------------------------XMTX?To|XB?EXT|BoB--?oXT|Moo?XB?EMM?ME-|TTEX?--BXMXE|oT-M?|MXXEX-B?B-T-EBX|TEX--oMTTT|M-T?||MME|||XB|X|E-TTMTooB|E?--------------------------------------||EEX-
-----------------------------------------------?T?oET|M?BX|oEB|B?-EXoTTM?T?To?M|M-ME-?oB?-XEX-E|BET-----------------------------------------------------------------------------------------------o??MB-
--------?ooToBEXBB?BMBT-ToTX?X-BoBBo|EBo|M?BX|?MXXXETM-|EMXoTTTMo-||XBToooBX-|Too--E?B?||XM??o----------------------------------------X|EM-?ooXTooM?|o?XX|BEX|---------------------------BT-XEEBE|M--XM-
--------------BXM?TM|B|-|oB?M|E|M-MTM---||BBMMX|-------------------------------------------------------------------------------------------?M|MEo-o--TXB?oXTT-ETT-??--oTTBTTB|-BXBX|BBEo-T?B-|?|MMTBMoo-
-----To|?XX?-BTEMTo|EMB?ETTE-BB-EM--M?-X|X?E?||BoX|?||?--TMBEB-MoBBBoT?MoT?oB?o-BXM?M?To|EE?TB-TTXXB|Eo|XMB|M|T|o||XBX|MXE-EBTM-|XTBB|M|BX-B-BoBX?|-XTEBTX|MMooXM-ME-----------------X|ME?--||-ToB-?XTX-
--------oMBT|T|Bo?TTEEEBE-XM|o-TXMTEEoEoMETTMBMM-o?o-BTM?M||T|T?MMToMo|E-ME?oToM--EEMTTBXEE?ooTTMEoM?T?M-ET|M-X?MTMT||oXM?MXTE?E?oBTEE-TB|EME----------------------------------------MB-EBXX??o?-TB|||Xv
------------------?BB||oE|--?EoTXoBXX|BEoT?B|?|oM--Boo||||oMo-MoXBMMXT-----------------------------------------------------------------------------------------------------B-ToEEE|?|X----EMX|TMB|E??oXf
------------------BTXT||M-?TEBTX?XT-TMBEMEETX?o|BT|MBMMooME?TM-??-BBB-oB|BBE||--ToEMoMXM-T||--M-oo-BTTX|oX-ETXTX--o-E-XTB|XXT-B|BooE?|oXo-BoXTT-MEM|M|M?EXB|T|TTEM|X|-o-BEo|EE|oMoX-----------|E-M?EoB?f
-------o|XXB-MoXoM-o?-X-XTTXTTXo|E-EM|TTETE?-||TMTEo|M-M-BooETXXE?oMM-X|Mo-----------X-oBXoM?-B?-E-TT|?oTTE|-?|-ooMM?ETX|-B|MBE|ETEEE|B-M?XTooXTT-XTXTo----------------------------------TBoTTXB|-o|B-Bf
-----|?TMoE?M??X?-oM|BEBMEE-ToBMoo|oXBMoXXoMBTX|BEXX-E|B-?EEXE|-------------------------------------------------------------------------------------------------------------------------------------XBMf
----------|BBETEB|BM|MM|ooX?X-EE?oBMX-B|?|XX|M|o-B---------|EMooMM||TMBBoM-?BXM-EXTT-TB?B|E-|T-BX|MTE-TE--oTBBM-oMooBTTTEXTX-XoXT?M?-M?||Bo|ooXEo|B??EXMoXXTTB-M-EBB--o?|M|-o?XoXME-MT?oM-XE?XBEo--T|o?f
----------------------------------------------------------------------------------------------------------------------------EMMo???X--------------------------MMMM?M|X||X|M-M?|?ETo-TBB?-EoXMXBBB|?MoE?f
m-XXT|o-XMXoX--XEX-|?BoBMBM?oT?-|TM-oTMT-T-T||oMBBEBXBE?EoMBXE--o-B?E-BXXB?M-B-X|Mo?|-??BEB||oo|EEoMooEM|MM?-?-oE-MM?-X-XBooXBoM-oBTBTTB|?EE-?X-----------------------------------------M-MXTTB-B-EoEMXX
XXXXXXXXXXXXXXXXXXXXXXXXXXXXXXXXXXXXXXXXXXXXXXXXXXXXXXXXXXXXXXXXXXXXXXXXXXXXXXXXXXXXXXXXXXXXXXXXXXXXXXXXXXXXXXXXXXXXXXXXXXXXXXXXXXXXXXXXXXXXXXXXXXXXXXXXXXXXXXXXXXXXXXXXXXXXXXXXXXXXXXXXXXXXXXXXXXXXXXXX
