---o-----------------------------------------------------------------XXXX-------------------------------------------------------------------------------------------------------------------------------
----------M------------------------------X--------------M--------------o-----------------M---------------------------------o----------------------------------------------------------------------------
------------------X--------o-----------------------------------------------------------------------------------------------------------------------M---o-o----------------------------------------------
-------------------------------------------------------BBBBB--------------------------------------------------------------------------------------------------------------------------------------------
-------o----------------------------------B-------------------??---M-----X---------------------------------------------------------------------------------------------------------------------------?--
----------B-------------------------------------------------------------XX------------------------------?-----------------------------------------------------------------------------------------------
---------o-------------------------------------------------------------XXX----------------------------------------------------X-----------B--------------------------------------------------B----------
----------------------------------------------------------------------XXXX----------BBBBBBBB-------------------------------------B---------o-------------------------------------------?---------------v
----------------------------------X----o-----------------------------XXXXX-----M-------------------------------------------------------------B---------------------------------------------------------f
-----------------------------------------------------o----------?---XXXXXX--------------------------------------M--------------------------------------------------------------------------------------f
-------------------------------------------------------------------XXXXXXX---------------------------------------M-------------------------------------------------------------------------------------f
----------------------------XXX--------------o--------------------XXXXXXXX--------------------------------------------------------------o------------------------?-------------------------------------f
------------X--------------------------o--?--M--T--T-------------XXXXXXXXX--------------------------------BBBBBT-------------------------?-------------o--X--------------------------------------------f
------------XX--------------X-------------------|--|------------XXXXXXXXXX----------------------o--------------|---------------------------------------------------------------------------------------f
mE-----o----XXX------------XX-----------E-------|--|-----E--o--XXXXXXXXXXX---------E----E-----E---BBBBB--------|--E----------EX------------------------------------------------------------------------X
XXXXXXXXXXXXXXXX-XXXXXX---XXXXXXXXXX------XXXXXX|XX|XXXXXXXXXXXXXXXXXXXXXXXXXXXXXXXXXXXXXXXXXXXXX-------XXXXXXX|XXXXXXXXXXXXXXXXXXXXXXXXXXXXX--------XXXXXXXXXXXXXXXXXXXXXXXXXXXXXX--------XXXXXXXXXXXXX
