---------------M-------B------?M-----------------o-------------------------------o-------------------------o----------o--------M----o-X---------------X-----------------o----------B------------------o-
-----------o-------XBM-E--------o-------------B-----------------o-B-X---------------------------------------------------------E------------------------o------------o---------?M-----------------------X
---E---------X-B-----------X----------o-------o------o------------o----------------B----------E----B--------B-------------------------------------------------------E--------B-----------B-BE-o---------
-----------------------------------------------X-B---------------oo---------------------------X------B--------E---------------------B----------B-B---------oB-----------------------------B------------B
?-----------------------------o---?--------?------------o-------o-------------o--------oo-------------------------o--------------o--M-----BM-------------------o------Xo------B-------o--o----o---------
--?-----o---X-------E----B--?---?-o----------------B-------------o----------EX---------B-----------------o--o-----------?------X---------E---B----------------------------?-------------o---------------
-------------o-BE----o--B-----------M-B--M-------?---------------o----------------------------X----M--B-----X--------------------E---B-------B-----------------B------B-B----------E-------?---oB-o-----
o---?-----B-----B--X------E-?----o--------------------o-----------M-B-----oo-----B-----------------B------------o----B--B-----B-------------------B--X----o--B--o--------------------E-------X---------v
------------------------oB?-----------------------------o-------B--o----------B---------------------oB-----------------B------o----------------------X--------E----------------------o-----o-----B------
EB-----o--B-------------o-o---------o-------------------------oX-------------------------------------------o-------------E--o---B---------------------o--------E---------o---------------B--------------
--oo-o-----------o-----o-----------------------o---T--------------X-o---------M------T---------B----------------------------E---------------------o-------X-B------------------------B---------B--------
---------o-----------o------E---B-----B------------|----o-B--------?-----------------|---o------------?---------------B----------------M-?----T--------X-----------E----------oE-----?---------T--B-----
E-------T-------------EX-----o---B-----------X-----|-------------Bo-------B----------|------------E-------------------------------------------|--------------X-----o---o--X-------o-----o------|--------
----X---|---------------------M--------------------|-oT-B--------------B---------B---|B--------o--B--------E----------------------------o-----|---B-----------o-o------------------------------|--------
m----M--|------B----------------o---------------X--|--|-E----o----------o--o-----o---|----------------------------------X-----------X----B----|T----E------------------------------o-----X-----|oo---?--
XXXXXXXX|XXXXXXXXXXXXXXXXXXXXXXXXXXXXXXXXXXXXXXXXXX|XX|XXXXXXXXXXXXXXXXXXXXXXXXXXXXXX|XXXXXXXXXXXXXXXXXXXXXXXXXXXXXXXXXXXXXXXXXXXXXXXXXXXXXXXX||XXXXXXXXXXXXXXXXXXXXXXXXXXXXXXXXXXXXXXXXXXXXXXX|XXXXXXXX
