------------------------------------------------------------XXXXXXX-------------------M------------------o----------------------------------------------------------X-----------------------------------
----------M-----------------------------------------------------------------------------------------------------------o---------------------------------------------------------------------------------
----------------------------------------------------------------X---------------------------------------------------------------------------------------------------------------------------------------
---------------------------------------------------------------------------------------------XXXX???????---------------------o-------------------o---------------------------o-----------------X--------
-------------------------X-----o-----------B------------------------o--BBBBBBB----------------------B--------------------------------------------B-------------------------------????-------------------
-M------------------------------------X-----------------------------------------------------------------------------------------------------------BBB---------------------------------------------------
-------------------------------------XX------------o-------------------------???????B---------------------X-------------XB---------------??--------------?----------------------------------------------
---------------------------o--------XXX------------------------XX----------------------------------------XX-------------------------?------------------------------------------o-----------------------v
-------------------T---------------XXXX-----------------------------------------------------------------XXX--------------------X----------------------------------o------------------------------------f
-------------------|--------------XXXXX----------------------------------------------------------------XXXX----------B--------XX------------------------------------------T----------------------------f
-------X-----------|o------------XXXXXX---XXX-----------------B-------------------------o-------------XXXXX------------------XXX------------------------------------------|----------------------------f
-------XX--------B-|------------XXXXXXX----------BB-------------------T-----------------M---T--------XXXXXX-----------------XXXX---------------------------------------BB-|----------------------------f
-------XXX---------|-----------XXXXXXXX---------------------XX--------|----T---------------M|-------XXXXXXX----------------XXXXX------------------------------------------|----------------------------f
-------XXXX--------|----------XXXXXXXXX-------------------------------|----|------T---------|------XXXXXXXX-----TT--------XXXXXX---X----M---------------------------------|----------------------------f
m---B--XXXXX-------|-------E-XXXXXXXXXX------------E-E---------------E|-E--|-E----|-------E-|E----XXXXXXXXX--E--||???E???XXXXXXX-------E---------------------------------E|-E-------------------------oX
XX---XXXXXXXXXXXXXX|XXXXXXXXXXXXXXXXXXXXXXXX---X---XXXXXXXXXXXXXXXXXXX|X---|----XX|XX-----XX|XX-XXXXXXXXXXXX--XX||XX--XXXXXXXXXXXXXXXXXXBXXXXXX--XXXXXXXXXXXXXXXXXXXXXXXXX|XXX-------XXXXXXXX-------XXXX
