X------------B--?-------------o-------?----------B---o-oB----------o----B-o-X------------o-o---o------X-o---------------------?--------o-----o--------X----------o------?------o--B-o--E--B-----------M-
------------------X-------------?---o-------o---------------B----------E-o-o--------------------------E----------------------------------B-X--E--E---------o-------------------o---------X-----------o--
--------------B-------?-o---o--E---E-------------E-----------o--o--E-------------?-----o---------E--------o-?----B-------------o--B---o---------------------?------E-------E-------------o----B---------
-------B------------------------------------------------------B-o------------B-M---B---o-----X-?-o-----------------------------X----------------------M---?-----------------------Boo-----B-------------
----------o--------------o-----------B---------------B---------o------M-o------o--------------M-------X--------B-----o---------------X-?----------------------------B--------E-o-B------o--X-----o------
M-----o?-?-EM-----M--E-------B-----------B-----o-----o---------------o------------------------B---oX-----?---------o-------B----------o----E------------X--------------X--------------------------------
---------------------o----------o---------------o-------B---------------------oo--------o--o--------?------------------B----------o-o-----?-----o-------o---------------o---------------M-----?-o-------
---E----------------------X-------------E-------X-----?-B-------oM-------------B----?------oB--------?------------------X------------o---------------X----BBo-B-B---------E-------------------o---o----v
B----E---------------------o-oB----------------o-X---------------X-----------o----o-------o--o----o--oB--o---E------------M----------------o---o-o-------B----------------o-?-?-------------Eo----------
---BE----------B-------------E---------B---B-o-----------E----------------------------------o---------------o--------------------------------------?-o-----Boo------------------------------------------
--------T----o-------E--M------o-----B------------oB--B-------B---------------B-----------o--o---X-------------o--X----------------------BX-----------------M------------oE----o--------?---o-----------
--------|-----------B-----------B---?o---B----------------------------------------o-o-?----------------------E--------o-----------------------E----------------?------B-----o-----------Boo--------B--o-
B-X-----|-MM-------------o?--o----B---------------o----------X---------o---o-----------B-----B----?--------------T-------------o------------o-------------M-T-----------------------o---T-o-------------
----?---|---?---------------------------o-oo--------------X--T-------------------E---BX------o---o------B---o----|o---------------------oB--B-----B---------|-o-----------------------oo|--Xo----------M
m-------|-B-----------?B------------B-B------E-----------B---|---o--------X---------M-------------o----o---------|-----o---------B--------o-----o--------o--|---o-----------------------|--o------------
XXXXXXXX|X-XXX-XXXXXXXXXXXXXXXXXX-X-XXXXXXXXXXXXXXXXXXXXXXXXX|XXXXXXXXXXXX-XXXXX-XXXXXXXXXX-XXXXXXXXXXXX-XXXXXXXX|XXXXXXXXXXXXXXXXXXXXXXXXXXXXXXXXXXXX-X--XX|XXXX-XXXXXXXXX-XXXXXX-XXXXX|XXXXXXXXXXXXXXX
