?o------------------------o--------------B--o----?-----B?----------B------------------------------------------------------------------oo-----------o-o-E--------B---------------------o-----------------
o---E----B-------B---------------B---------?E-------E-----M----------------X-?-------------------o---------B---------X---------M------B-------B----------------oo-------o-o--------o----o---------------
----o---E---o---o----------------------------o---------------------o-Eo-------------------------------o-----------B-------E---------E--o------o----------E-----------------o----------o------B-oX---o---
---------------------X-------B---?-o---B--------o-----------o----o----------B-------------X--B-----------B-o------o------o--E--------o---------------------------------------------?-o------------------
--o------------------E----------X------o--------X----o--X--------------o--------------------------------E--------------E?----------o-------------oB------------o-------o-B----B------o--o----------oo-?-
----------o---o-------------o----------------B--------------B---?---o-o-----------X-?---------------X---o--------B----o-------M-----------B-XE------------?------------o-------------------------B-----o
B-----o-E---o--------o-----------------o--B---------B----o----o-----------------------B---M------------M-o---o-------o-------o----------------B--------B---------------------------------o-o-B----BX--o-
------------B--?----M-XB---X---------------o-o--------o--------B------X--------o------------B-----o----E---B--------B---------B?----B----o-----------o-------------------B------o-------M------------o-v
-X---EE----o---------------B----------------------X-------------------B-----B----o---------B--------Eoo--oM-----------------------------------------------------------------X--------------------------f
---?--E----------B------o-?-B---------------E-----------o---------EB------E------B----------o-------B-o-----------------E----B---o---------------------o--o-------?------------------------------------f
B----------------oB-E----o-------oT----------------------------------?---------------------------E------------?--------------E-------------o-------------------M------------oo---------X----T--------T-f
----------o---B----o------o-------|--M----------o----M-------------------M-----Bo-----------------o------------------o---X----o-------------B-----?--------o-------B---B----E---------------|E-------|-f
---------o---B--E---------B------T|-----B---o-----o-----------B--------------To-----E-----------------o---o----o---------------E---o------------o------B--------X-X---------o-T---o---------|--B-----|-f
--B------------------------------||o---B--------B---o-M-----o--------MB------|--o-----o--B---------------Bo-B--------M-----o--o---------------oo-----o-----T------------------|-o-----------|--------|-f
m--------B-----B-Bo---------B----||--------------------------B-------?-o-o---|----------------------------E-B--------o----o-o-oE?-----o---------M----------|----B---B--E------|-------o-----|--------|-X
XXXXXXXXXXXXXXXXXXXXXXXXXXXXXXXXX||XXXXXXXXX-XX-XXXXXXXXXXXXXX-XXXXXXXXXXXXXX|XXXXXXXXXXXXXXXXXXXXXXXXXXXXXXXXXX--X-XXXXXXX-XXXXXXXXXXXXXXXXXXXX-XXXXXXXXXXX-XXXXXXXXXXXXXXXXXXXXXXXXXXXXXXXXXXXXXXXXXXX
